"","Zipcodes","InquiryMale","InquiryFemale","InquiryTotal","InquiryMalePercentage","InquiryFemalePercentage","AppliedMale","AppliedFemale","AppliedTotal","AppliedMalePercentage","AppliedFemalePercentage","AcceptedMale","AcceptedFemale","AcceptedTotal","AcceptedMalePercentage","AcceptedFemalePercentage","EnrolledMale","EnrolledFemale","EnrolledTotal","EnrolledMalePercentage","EnrolledFemalePercentage"
"1","98001",13,35,48,0.270833333333333,0.729166666666667,5,9,14,0.642857142857143,0.357142857142857,1,5,6,0.166666666666667,0.833333333333333,1,1,2,0.5,0.5
"2","98002",5,14,19,0.263157894736842,0.736842105263158,0,3,3,1,0,0,1,1,0,1,0,0,0,NA,NA
"3","98003",19,41,60,0.316666666666667,0.683333333333333,6,13,19,0.68421052631579,0.315789473684211,2,2,4,0.5,0.5,0,0,0,NA,NA
"4","98004",35,29,64,0.546875,0.453125,20,13,33,0.393939393939394,0.606060606060606,4,1,5,0.8,0.2,1,1,2,0.5,0.5
"5","98005",20,17,37,0.540540540540541,0.459459459459459,10,6,16,0.375,0.625,4,1,5,0.8,0.2,2,2,4,0.5,0.5
"6","98006",57,69,126,0.452380952380952,0.547619047619048,20,24,44,0.545454545454545,0.454545454545455,5,9,14,0.357142857142857,0.642857142857143,3,3,6,0.5,0.5
"7","98007",15,9,24,0.625,0.375,5,2,7,0.285714285714286,0.714285714285714,1,0,1,1,0,1,1,2,0.5,0.5
"8","98008",22,26,48,0.458333333333333,0.541666666666667,6,8,14,0.571428571428571,0.428571428571429,3,2,5,0.6,0.4,1,1,2,0.5,0.5
"9","98009",1,2,3,0.333333333333333,0.666666666666667,0,2,2,1,0,0,0,0,NA,NA,0,0,0,NA,NA
"10","98010",4,2,6,0.666666666666667,0.333333333333333,1,1,2,0.5,0.5,0,1,1,0,1,0,0,0,NA,NA
"11","98011",15,24,39,0.384615384615385,0.615384615384615,4,4,8,0.5,0.5,1,0,1,1,0,0,0,0,NA,NA
"12","98012",28,44,72,0.388888888888889,0.611111111111111,10,15,25,0.6,0.4,3,3,6,0.5,0.5,0,0,0,NA,NA
"13","98014",5,5,10,0.5,0.5,0,0,0,NA,NA,0,0,0,NA,NA,0,0,0,NA,NA
"14","98015",0,1,1,0,1,0,0,0,NA,NA,0,0,0,NA,NA,0,0,0,NA,NA
"15","98019",7,8,15,0.466666666666667,0.533333333333333,6,4,10,0.4,0.6,3,2,5,0.6,0.4,2,2,4,0.5,0.5
"16","98020",19,30,49,0.387755102040816,0.612244897959184,6,10,16,0.625,0.375,1,3,4,0.25,0.75,1,1,2,0.5,0.5
"17","98021",12,19,31,0.387096774193548,0.612903225806452,3,12,15,0.8,0.2,0,5,5,0,1,0,0,0,NA,NA
"18","98022",11,17,28,0.392857142857143,0.607142857142857,5,7,12,0.583333333333333,0.416666666666667,1,3,4,0.25,0.75,0,0,0,NA,NA
"19","98023",30,69,99,0.303030303030303,0.696969696969697,9,20,29,0.689655172413793,0.310344827586207,0,3,3,0,1,0,0,0,NA,NA
"20","98024",4,9,13,0.307692307692308,0.692307692307692,3,3,6,0.5,0.5,2,1,3,0.666666666666667,0.333333333333333,1,1,2,0.5,0.5
"21","98026",28,51,79,0.354430379746835,0.645569620253165,10,25,35,0.714285714285714,0.285714285714286,4,6,10,0.4,0.6,1,1,2,0.5,0.5
"22","98027",32,43,75,0.426666666666667,0.573333333333333,11,14,25,0.56,0.44,4,4,8,0.5,0.5,1,1,2,0.5,0.5
"23","98028",20,26,46,0.434782608695652,0.565217391304348,4,14,18,0.777777777777778,0.222222222222222,0,3,3,0,1,0,0,0,NA,NA
"24","98029",22,34,56,0.392857142857143,0.607142857142857,6,9,15,0.6,0.4,2,3,5,0.4,0.6,1,1,2,0.5,0.5
"25","98030",17,23,40,0.425,0.575,3,6,9,0.666666666666667,0.333333333333333,0,0,0,NA,NA,0,0,0,NA,NA
"26","98031",28,34,62,0.451612903225806,0.548387096774194,8,10,18,0.555555555555556,0.444444444444444,1,1,2,0.5,0.5,0,0,0,NA,NA
"27","98032",7,22,29,0.241379310344828,0.758620689655172,1,7,8,0.875,0.125,0,1,1,0,1,0,0,0,NA,NA
"28","98033",28,38,66,0.424242424242424,0.575757575757576,8,11,19,0.578947368421053,0.421052631578947,1,0,1,1,0,0,0,0,NA,NA
"29","98034",17,45,62,0.274193548387097,0.725806451612903,2,14,16,0.875,0.125,0,2,2,0,1,0,0,0,NA,NA
"30","98036",20,26,46,0.434782608695652,0.565217391304348,3,8,11,0.727272727272727,0.272727272727273,0,0,0,NA,NA,0,0,0,NA,NA
"31","98037",6,25,31,0.193548387096774,0.806451612903226,1,8,9,0.888888888888889,0.111111111111111,0,1,1,0,1,0,0,0,NA,NA
"32","98038",24,26,50,0.48,0.52,6,3,9,0.333333333333333,0.666666666666667,3,0,3,1,0,1,1,2,0.5,0.5
"33","98039",10,7,17,0.588235294117647,0.411764705882353,5,6,11,0.545454545454545,0.454545454545455,0,1,1,0,1,0,0,0,NA,NA
"34","98040",29,42,71,0.408450704225352,0.591549295774648,7,16,23,0.695652173913043,0.304347826086957,1,4,5,0.2,0.8,0,0,0,NA,NA
"35","98042",33,52,85,0.388235294117647,0.611764705882353,4,13,17,0.764705882352941,0.235294117647059,1,1,2,0.5,0.5,1,1,2,0.5,0.5
"36","98043",5,11,16,0.3125,0.6875,0,1,1,1,0,0,1,1,0,1,0,0,0,NA,NA
"37","98045",8,20,28,0.285714285714286,0.714285714285714,3,5,8,0.625,0.375,1,0,1,1,0,0,0,0,NA,NA
"38","98046",1,1,2,0.5,0.5,0,0,0,NA,NA,0,0,0,NA,NA,0,0,0,NA,NA
"39","98047",2,1,3,0.666666666666667,0.333333333333333,0,0,0,NA,NA,0,0,0,NA,NA,0,0,0,NA,NA
"40","98050",1,0,1,1,0,1,0,1,0,1,1,0,1,1,0,0,0,0,NA,NA
"41","98051",1,1,2,0.5,0.5,0,0,0,NA,NA,0,0,0,NA,NA,0,0,0,NA,NA
"42","98052",45,41,86,0.523255813953488,0.476744186046512,16,9,25,0.36,0.64,3,0,3,1,0,0,0,0,NA,NA
"43","98053",23,17,40,0.575,0.425,12,5,17,0.294117647058824,0.705882352941177,3,0,3,1,0,1,1,2,0.5,0.5
"44","98055",5,14,19,0.263157894736842,0.736842105263158,2,5,7,0.714285714285714,0.285714285714286,0,1,1,0,1,0,0,0,NA,NA
"45","98056",12,23,35,0.342857142857143,0.657142857142857,4,6,10,0.6,0.4,1,0,1,1,0,0,0,0,NA,NA
"46","98057",4,11,15,0.266666666666667,0.733333333333333,0,6,6,1,0,0,1,1,0,1,0,0,0,NA,NA
"47","98058",22,50,72,0.305555555555556,0.694444444444444,10,13,23,0.565217391304348,0.434782608695652,2,2,4,0.5,0.5,0,0,0,NA,NA
"48","98059",20,33,53,0.377358490566038,0.622641509433962,8,8,16,0.5,0.5,0,1,1,0,1,0,0,0,NA,NA
"49","98062",0,2,2,0,1,0,2,2,1,0,0,0,0,NA,NA,0,0,0,NA,NA
"50","98063",0,1,1,0,1,0,0,0,NA,NA,0,0,0,NA,NA,0,0,0,NA,NA
"51","98065",3,12,15,0.2,0.8,0,1,1,1,0,0,0,0,NA,NA,0,0,0,NA,NA
"52","98070",3,9,12,0.25,0.75,0,0,0,NA,NA,0,0,0,NA,NA,0,0,0,NA,NA
"53","98072",28,31,59,0.474576271186441,0.525423728813559,8,10,18,0.555555555555556,0.444444444444444,3,4,7,0.428571428571429,0.571428571428571,3,3,6,0.5,0.5
"54","98073",0,1,1,0,1,0,1,1,1,0,0,0,0,NA,NA,0,0,0,NA,NA
"55","98074",31,38,69,0.449275362318841,0.550724637681159,11,9,20,0.45,0.55,1,2,3,0.333333333333333,0.666666666666667,1,1,2,0.5,0.5
"56","98075",26,42,68,0.382352941176471,0.617647058823529,11,14,25,0.56,0.44,2,3,5,0.4,0.6,0,0,0,NA,NA
"57","98077",16,31,47,0.340425531914894,0.659574468085106,9,9,18,0.5,0.5,0,2,2,0,1,0,0,0,NA,NA
"58","98082",0,3,3,0,1,0,0,0,NA,NA,0,0,0,NA,NA,0,0,0,NA,NA
"59","98083",1,0,1,1,0,0,0,0,NA,NA,0,0,0,NA,NA,0,0,0,NA,NA
"60","98087",7,14,21,0.333333333333333,0.666666666666667,4,2,6,0.333333333333333,0.666666666666667,1,1,2,0.5,0.5,1,1,2,0.5,0.5
"61","98089",0,1,1,0,1,0,0,0,NA,NA,0,0,0,NA,NA,0,0,0,NA,NA
"62","98092",22,34,56,0.392857142857143,0.607142857142857,5,10,15,0.666666666666667,0.333333333333333,0,1,1,0,1,0,0,0,NA,NA
"63","98093",1,1,2,0.5,0.5,1,1,2,0.5,0.5,0,0,0,NA,NA,0,0,0,NA,NA
"64","98101",0,2,2,0,1,0,1,1,1,0,0,0,0,NA,NA,0,0,0,NA,NA
"65","98102",9,7,16,0.5625,0.4375,4,1,5,0.2,0.8,2,0,2,1,0,0,0,0,NA,NA
"66","98103",12,25,37,0.324324324324324,0.675675675675676,2,8,10,0.8,0.2,0,1,1,0,1,0,0,0,NA,NA
"67","98104",4,1,5,0.8,0.2,0,1,1,1,0,0,0,0,NA,NA,0,0,0,NA,NA
"68","98105",29,33,62,0.467741935483871,0.532258064516129,17,15,32,0.46875,0.53125,2,0,2,1,0,1,1,2,0.5,0.5
"69","98106",8,10,18,0.444444444444444,0.555555555555556,1,4,5,0.8,0.2,0,1,1,0,1,0,0,0,NA,NA
"70","98107",4,5,9,0.444444444444444,0.555555555555556,3,2,5,0.4,0.6,2,0,2,1,0,1,1,2,0.5,0.5
"71","98108",15,11,26,0.576923076923077,0.423076923076923,5,3,8,0.375,0.625,0,0,0,NA,NA,0,0,0,NA,NA
"72","98109",5,8,13,0.384615384615385,0.615384615384615,3,3,6,0.5,0.5,2,0,2,1,0,1,1,2,0.5,0.5
"73","98110",28,42,70,0.4,0.6,3,12,15,0.8,0.2,2,1,3,0.666666666666667,0.333333333333333,1,1,2,0.5,0.5
"74","98112",19,20,39,0.487179487179487,0.512820512820513,8,10,18,0.555555555555556,0.444444444444444,1,1,2,0.5,0.5,0,0,0,NA,NA
"75","98115",43,47,90,0.477777777777778,0.522222222222222,18,17,35,0.485714285714286,0.514285714285714,5,4,9,0.555555555555556,0.444444444444444,2,2,4,0.5,0.5
"76","98116",15,18,33,0.454545454545455,0.545454545454545,7,7,14,0.5,0.5,1,0,1,1,0,1,1,2,0.5,0.5
"77","98117",18,18,36,0.5,0.5,7,8,15,0.533333333333333,0.466666666666667,1,1,2,0.5,0.5,1,1,2,0.5,0.5
"78","98118",18,39,57,0.315789473684211,0.68421052631579,9,13,22,0.590909090909091,0.409090909090909,0,1,1,0,1,0,0,0,NA,NA
"79","98119",8,8,16,0.5,0.5,4,1,5,0.2,0.8,1,1,2,0.5,0.5,1,1,2,0.5,0.5
"80","98121",2,2,4,0.5,0.5,0,0,0,NA,NA,0,0,0,NA,NA,0,0,0,NA,NA
"81","98122",9,14,23,0.391304347826087,0.608695652173913,2,6,8,0.75,0.25,0,2,2,0,1,0,0,0,NA,NA
"82","98125",15,31,46,0.326086956521739,0.673913043478261,3,13,16,0.8125,0.1875,2,2,4,0.5,0.5,2,2,4,0.5,0.5
"83","98126",4,16,20,0.2,0.8,2,6,8,0.75,0.25,0,4,4,0,1,0,0,0,NA,NA
"84","98127",0,1,1,0,1,0,0,0,NA,NA,0,0,0,NA,NA,0,0,0,NA,NA
"85","98133",8,24,32,0.25,0.75,4,8,12,0.666666666666667,0.333333333333333,0,1,1,0,1,0,0,0,NA,NA
"86","98136",10,17,27,0.370370370370370,0.62962962962963,3,7,10,0.7,0.3,2,2,4,0.5,0.5,2,2,4,0.5,0.5
"87","98139",0,3,3,0,1,0,2,2,1,0,0,0,0,NA,NA,0,0,0,NA,NA
"88","98144",11,16,27,0.407407407407407,0.592592592592593,4,7,11,0.636363636363636,0.363636363636364,2,0,2,1,0,2,2,4,0.5,0.5
"89","98145",1,1,2,0.5,0.5,1,1,2,0.5,0.5,0,0,0,NA,NA,0,0,0,NA,NA
"90","98146",8,32,40,0.2,0.8,4,7,11,0.636363636363636,0.363636363636364,1,2,3,0.333333333333333,0.666666666666667,0,0,0,NA,NA
"91","98148",3,6,9,0.333333333333333,0.666666666666667,0,4,4,1,0,0,0,0,NA,NA,0,0,0,NA,NA
"92","98155",19,41,60,0.316666666666667,0.683333333333333,9,15,24,0.625,0.375,2,3,5,0.4,0.6,1,1,2,0.5,0.5
"93","98166",11,24,35,0.314285714285714,0.685714285714286,8,11,19,0.578947368421053,0.421052631578947,3,3,6,0.5,0.5,1,1,2,0.5,0.5
"94","98168",8,15,23,0.347826086956522,0.652173913043478,4,4,8,0.5,0.5,1,2,3,0.333333333333333,0.666666666666667,0,0,0,NA,NA
"95","98177",22,39,61,0.360655737704918,0.639344262295082,9,20,29,0.689655172413793,0.310344827586207,2,7,9,0.222222222222222,0.777777777777778,1,1,2,0.5,0.5
"96","98178",10,22,32,0.3125,0.6875,3,13,16,0.8125,0.1875,0,0,0,NA,NA,0,0,0,NA,NA
"97","98188",8,17,25,0.32,0.68,5,7,12,0.583333333333333,0.416666666666667,1,2,3,0.333333333333333,0.666666666666667,0,0,0,NA,NA
"98","98198",15,30,45,0.333333333333333,0.666666666666667,4,11,15,0.733333333333333,0.266666666666667,2,2,4,0.5,0.5,0,0,0,NA,NA
"99","98199",18,31,49,0.36734693877551,0.63265306122449,8,16,24,0.666666666666667,0.333333333333333,2,6,8,0.25,0.75,0,0,0,NA,NA
"100","98201",4,20,24,0.166666666666667,0.833333333333333,0,9,9,1,0,0,2,2,0,1,0,0,0,NA,NA
"101","98203",18,24,42,0.428571428571429,0.571428571428571,3,7,10,0.7,0.3,1,0,1,1,0,0,0,0,NA,NA
"102","98204",2,11,13,0.153846153846154,0.846153846153846,0,1,1,1,0,0,0,0,NA,NA,0,0,0,NA,NA
"103","98205",3,4,7,0.428571428571429,0.571428571428571,0,2,2,1,0,0,0,0,NA,NA,0,0,0,NA,NA
"104","98206",0,2,2,0,1,0,0,0,NA,NA,0,0,0,NA,NA,0,0,0,NA,NA
"105","98208",18,34,52,0.346153846153846,0.653846153846154,7,12,19,0.631578947368421,0.368421052631579,1,0,1,1,0,0,0,0,NA,NA
"106","98213",0,1,1,0,1,0,0,0,NA,NA,0,0,0,NA,NA,0,0,0,NA,NA
"107","98220",0,1,1,0,1,0,1,1,1,0,0,0,0,NA,NA,0,0,0,NA,NA
"108","98221",5,20,25,0.2,0.8,1,2,3,0.666666666666667,0.333333333333333,0,1,1,0,1,0,0,0,NA,NA
"109","98223",11,26,37,0.297297297297297,0.702702702702703,3,6,9,0.666666666666667,0.333333333333333,1,2,3,0.333333333333333,0.666666666666667,0,0,0,NA,NA
"110","98225",9,29,38,0.236842105263158,0.763157894736842,0,9,9,1,0,0,3,3,0,1,0,0,0,NA,NA
"111","98226",16,30,46,0.347826086956522,0.652173913043478,7,13,20,0.65,0.35,1,9,10,0.1,0.9,1,1,2,0.5,0.5
"112","98227",0,1,1,0,1,0,0,0,NA,NA,0,0,0,NA,NA,0,0,0,NA,NA
"113","98228",1,0,1,1,0,0,0,0,NA,NA,0,0,0,NA,NA,0,0,0,NA,NA
"114","98229",12,30,42,0.285714285714286,0.714285714285714,2,15,17,0.88235294117647,0.117647058823529,0,4,4,0,1,0,0,0,NA,NA
"115","98230",6,5,11,0.545454545454545,0.454545454545455,1,0,1,0,1,0,0,0,NA,NA,0,0,0,NA,NA
"116","98232",2,6,8,0.25,0.75,2,0,2,0,1,2,0,2,1,0,0,0,0,NA,NA
"117","98233",6,17,23,0.260869565217391,0.739130434782609,3,6,9,0.666666666666667,0.333333333333333,2,3,5,0.4,0.6,1,1,2,0.5,0.5
"118","98235",1,1,2,0.5,0.5,0,0,0,NA,NA,0,0,0,NA,NA,0,0,0,NA,NA
"119","98236",5,1,6,0.833333333333333,0.166666666666667,1,0,1,0,1,0,0,0,NA,NA,0,0,0,NA,NA
"120","98237",1,3,4,0.25,0.75,0,0,0,NA,NA,0,0,0,NA,NA,0,0,0,NA,NA
"121","98239",1,7,8,0.125,0.875,0,1,1,1,0,0,1,1,0,1,0,0,0,NA,NA
"122","98240",0,2,2,0,1,0,1,1,1,0,0,0,0,NA,NA,0,0,0,NA,NA
"123","98241",1,1,2,0.5,0.5,0,1,1,1,0,0,0,0,NA,NA,0,0,0,NA,NA
"124","98244",1,2,3,0.333333333333333,0.666666666666667,0,0,0,NA,NA,0,0,0,NA,NA,0,0,0,NA,NA
"125","98245",0,6,6,0,1,0,0,0,NA,NA,0,0,0,NA,NA,0,0,0,NA,NA
"126","98247",4,8,12,0.333333333333333,0.666666666666667,1,1,2,0.5,0.5,1,0,1,1,0,1,1,2,0.5,0.5
"127","98248",4,11,15,0.266666666666667,0.733333333333333,1,3,4,0.75,0.25,0,0,0,NA,NA,0,0,0,NA,NA
"128","98249",2,5,7,0.285714285714286,0.714285714285714,1,2,3,0.666666666666667,0.333333333333333,0,0,0,NA,NA,0,0,0,NA,NA
"129","98250",2,7,9,0.222222222222222,0.777777777777778,1,3,4,0.75,0.25,0,1,1,0,1,0,0,0,NA,NA
"130","98251",0,2,2,0,1,0,1,1,1,0,0,1,1,0,1,0,0,0,NA,NA
"131","98252",3,4,7,0.428571428571429,0.571428571428571,1,1,2,0.5,0.5,0,0,0,NA,NA,0,0,0,NA,NA
"132","98253",0,1,1,0,1,0,0,0,NA,NA,0,0,0,NA,NA,0,0,0,NA,NA
"133","98255",1,0,1,1,0,0,0,0,NA,NA,0,0,0,NA,NA,0,0,0,NA,NA
"134","98257",1,5,6,0.166666666666667,0.833333333333333,0,0,0,NA,NA,0,0,0,NA,NA,0,0,0,NA,NA
"135","98258",9,14,23,0.391304347826087,0.608695652173913,2,4,6,0.666666666666667,0.333333333333333,0,1,1,0,1,0,0,0,NA,NA
"136","98260",5,5,10,0.5,0.5,3,2,5,0.4,0.6,0,0,0,NA,NA,0,0,0,NA,NA
"137","98261",2,1,3,0.666666666666667,0.333333333333333,1,0,1,0,1,0,0,0,NA,NA,0,0,0,NA,NA
"138","98264",9,10,19,0.473684210526316,0.526315789473684,1,4,5,0.8,0.2,0,1,1,0,1,0,0,0,NA,NA
"139","98266",2,3,5,0.4,0.6,1,1,2,0.5,0.5,0,0,0,NA,NA,0,0,0,NA,NA
"140","98267",0,1,1,0,1,0,1,1,1,0,0,1,1,0,1,0,0,0,NA,NA
"141","98270",11,27,38,0.289473684210526,0.710526315789474,0,6,6,1,0,0,2,2,0,1,0,0,0,NA,NA
"142","98271",8,11,19,0.421052631578947,0.578947368421053,1,2,3,0.666666666666667,0.333333333333333,0,1,1,0,1,0,0,0,NA,NA
"143","98272",7,23,30,0.233333333333333,0.766666666666667,0,8,8,1,0,0,0,0,NA,NA,0,0,0,NA,NA
"144","98273",6,22,28,0.214285714285714,0.785714285714286,2,2,4,0.5,0.5,1,1,2,0.5,0.5,0,0,0,NA,NA
"145","98274",7,10,17,0.411764705882353,0.588235294117647,2,2,4,0.5,0.5,1,1,2,0.5,0.5,0,0,0,NA,NA
"146","98275",25,31,56,0.446428571428571,0.553571428571429,11,11,22,0.5,0.5,2,2,4,0.5,0.5,0,0,0,NA,NA
"147","98277",21,20,41,0.51219512195122,0.48780487804878,8,4,12,0.333333333333333,0.666666666666667,2,0,2,1,0,1,1,2,0.5,0.5
"148","98281",1,0,1,1,0,0,0,0,NA,NA,0,0,0,NA,NA,0,0,0,NA,NA
"149","98282",6,11,17,0.352941176470588,0.647058823529412,0,1,1,1,0,0,0,0,NA,NA,0,0,0,NA,NA
"150","98283",1,0,1,1,0,1,0,1,0,1,0,0,0,NA,NA,0,0,0,NA,NA
"151","98284",5,19,24,0.208333333333333,0.791666666666667,0,2,2,1,0,0,0,0,NA,NA,0,0,0,NA,NA
"152","98290",8,27,35,0.228571428571429,0.771428571428571,3,13,16,0.8125,0.1875,1,4,5,0.2,0.8,1,1,2,0.5,0.5
"153","98291",0,2,2,0,1,0,1,1,1,0,0,0,0,NA,NA,0,0,0,NA,NA
"154","98292",11,17,28,0.392857142857143,0.607142857142857,3,7,10,0.7,0.3,2,1,3,0.666666666666667,0.333333333333333,0,0,0,NA,NA
"155","98293",0,1,1,0,1,0,0,0,NA,NA,0,0,0,NA,NA,0,0,0,NA,NA
"156","98294",1,3,4,0.25,0.75,0,1,1,1,0,0,0,0,NA,NA,0,0,0,NA,NA
"157","98295",0,1,1,0,1,0,0,0,NA,NA,0,0,0,NA,NA,0,0,0,NA,NA
"158","98296",17,31,48,0.354166666666667,0.645833333333333,5,10,15,0.666666666666667,0.333333333333333,3,2,5,0.6,0.4,1,1,2,0.5,0.5
"159","98303",0,2,2,0,1,0,1,1,1,0,0,0,0,NA,NA,0,0,0,NA,NA
"160","98310",10,11,21,0.476190476190476,0.523809523809524,1,5,6,0.833333333333333,0.166666666666667,0,0,0,NA,NA,0,0,0,NA,NA
"161","98311",9,26,35,0.257142857142857,0.742857142857143,2,11,13,0.846153846153846,0.153846153846154,1,2,3,0.333333333333333,0.666666666666667,0,0,0,NA,NA
"162","98312",10,23,33,0.303030303030303,0.696969696969697,3,7,10,0.7,0.3,0,2,2,0,1,0,0,0,NA,NA
"163","98315",0,1,1,0,1,0,1,1,1,0,0,0,0,NA,NA,0,0,0,NA,NA
"164","98321",8,9,17,0.470588235294118,0.529411764705882,2,2,4,0.5,0.5,0,1,1,0,1,0,0,0,NA,NA
"165","98322",0,1,1,0,1,0,0,0,NA,NA,0,0,0,NA,NA,0,0,0,NA,NA
"166","98323",0,1,1,0,1,0,0,0,NA,NA,0,0,0,NA,NA,0,0,0,NA,NA
"167","98325",0,1,1,0,1,0,1,1,1,0,0,0,0,NA,NA,0,0,0,NA,NA
"168","98327",1,6,7,0.142857142857143,0.857142857142857,1,1,2,0.5,0.5,0,0,0,NA,NA,0,0,0,NA,NA
"169","98328",8,6,14,0.571428571428571,0.428571428571429,2,1,3,0.333333333333333,0.666666666666667,0,0,0,NA,NA,0,0,0,NA,NA
"170","98329",3,6,9,0.333333333333333,0.666666666666667,2,2,4,0.5,0.5,0,0,0,NA,NA,0,0,0,NA,NA
"171","98331",0,1,1,0,1,0,1,1,1,0,0,0,0,NA,NA,0,0,0,NA,NA
"172","98332",9,16,25,0.36,0.64,4,5,9,0.555555555555556,0.444444444444444,1,1,2,0.5,0.5,1,1,2,0.5,0.5
"173","98333",9,8,17,0.529411764705882,0.470588235294118,5,3,8,0.375,0.625,2,2,4,0.5,0.5,2,2,4,0.5,0.5
"174","98335",28,34,62,0.451612903225806,0.548387096774194,12,8,20,0.4,0.6,5,3,8,0.625,0.375,3,3,6,0.5,0.5
"175","98336",0,4,4,0,1,0,0,0,NA,NA,0,0,0,NA,NA,0,0,0,NA,NA
"176","98337",2,7,9,0.222222222222222,0.777777777777778,1,0,1,0,1,0,0,0,NA,NA,0,0,0,NA,NA
"177","98338",15,18,33,0.454545454545455,0.545454545454545,1,7,8,0.875,0.125,1,1,2,0.5,0.5,1,1,2,0.5,0.5
"178","98339",1,2,3,0.333333333333333,0.666666666666667,0,0,0,NA,NA,0,0,0,NA,NA,0,0,0,NA,NA
"179","98340",0,3,3,0,1,0,0,0,NA,NA,0,0,0,NA,NA,0,0,0,NA,NA
"180","98342",0,1,1,0,1,0,0,0,NA,NA,0,0,0,NA,NA,0,0,0,NA,NA
"181","98346",12,5,17,0.705882352941177,0.294117647058824,3,3,6,0.5,0.5,0,1,1,0,1,0,0,0,NA,NA
"182","98349",2,1,3,0.666666666666667,0.333333333333333,1,0,1,0,1,0,0,0,NA,NA,0,0,0,NA,NA
"183","98350",0,1,1,0,1,0,0,0,NA,NA,0,0,0,NA,NA,0,0,0,NA,NA
"184","98353",1,0,1,1,0,1,0,1,0,1,0,0,0,NA,NA,0,0,0,NA,NA
"185","98354",1,10,11,0.090909090909091,0.909090909090909,1,5,6,0.833333333333333,0.166666666666667,1,2,3,0.333333333333333,0.666666666666667,0,0,0,NA,NA
"186","98355",1,1,2,0.5,0.5,0,0,0,NA,NA,0,0,0,NA,NA,0,0,0,NA,NA
"187","98356",1,0,1,1,0,0,0,0,NA,NA,0,0,0,NA,NA,0,0,0,NA,NA
"188","98357",0,2,2,0,1,0,0,0,NA,NA,0,0,0,NA,NA,0,0,0,NA,NA
"189","98358",0,1,1,0,1,0,1,1,1,0,0,0,0,NA,NA,0,0,0,NA,NA
"190","98359",1,9,10,0.1,0.9,0,3,3,1,0,0,0,0,NA,NA,0,0,0,NA,NA
"191","98360",1,5,6,0.166666666666667,0.833333333333333,0,0,0,NA,NA,0,0,0,NA,NA,0,0,0,NA,NA
"192","98361",1,0,1,1,0,0,0,0,NA,NA,0,0,0,NA,NA,0,0,0,NA,NA
"193","98362",5,15,20,0.25,0.75,1,2,3,0.666666666666667,0.333333333333333,0,0,0,NA,NA,0,0,0,NA,NA
"194","98363",5,3,8,0.625,0.375,3,1,4,0.25,0.75,0,0,0,NA,NA,0,0,0,NA,NA
"195","98365",1,1,2,0.5,0.5,0,1,1,1,0,0,0,0,NA,NA,0,0,0,NA,NA
"196","98366",8,22,30,0.266666666666667,0.733333333333333,3,8,11,0.727272727272727,0.272727272727273,0,2,2,0,1,0,0,0,NA,NA
"197","98367",8,19,27,0.296296296296296,0.703703703703704,1,5,6,0.833333333333333,0.166666666666667,1,2,3,0.333333333333333,0.666666666666667,1,1,2,0.5,0.5
"198","98368",10,28,38,0.263157894736842,0.736842105263158,0,6,6,1,0,0,3,3,0,1,0,0,0,NA,NA
"199","98370",24,32,56,0.428571428571429,0.571428571428571,7,14,21,0.666666666666667,0.333333333333333,1,3,4,0.25,0.75,1,1,2,0.5,0.5
"200","98371",10,18,28,0.357142857142857,0.642857142857143,4,9,13,0.692307692307692,0.307692307692308,2,3,5,0.4,0.6,0,0,0,NA,NA
"201","98372",8,19,27,0.296296296296296,0.703703703703704,1,6,7,0.857142857142857,0.142857142857143,0,0,0,NA,NA,0,0,0,NA,NA
"202","98373",8,21,29,0.275862068965517,0.724137931034483,1,7,8,0.875,0.125,0,0,0,NA,NA,0,0,0,NA,NA
"203","98374",21,36,57,0.368421052631579,0.631578947368421,11,11,22,0.5,0.5,2,1,3,0.666666666666667,0.333333333333333,0,0,0,NA,NA
"204","98375",21,23,44,0.477272727272727,0.522727272727273,7,5,12,0.416666666666667,0.583333333333333,0,0,0,NA,NA,0,0,0,NA,NA
"205","98377",2,1,3,0.666666666666667,0.333333333333333,1,0,1,0,1,0,0,0,NA,NA,0,0,0,NA,NA
"206","98380",4,4,8,0.5,0.5,1,1,2,0.5,0.5,0,0,0,NA,NA,0,0,0,NA,NA
"207","98382",16,14,30,0.533333333333333,0.466666666666667,3,1,4,0.25,0.75,1,0,1,1,0,0,0,0,NA,NA
"208","98383",22,37,59,0.372881355932203,0.627118644067797,4,11,15,0.733333333333333,0.266666666666667,1,3,4,0.25,0.75,0,0,0,NA,NA
"209","98384",1,3,4,0.25,0.75,0,1,1,1,0,0,0,0,NA,NA,0,0,0,NA,NA
"210","98386",1,0,1,1,0,1,0,1,0,1,0,0,0,NA,NA,0,0,0,NA,NA
"211","98387",12,26,38,0.315789473684211,0.68421052631579,1,7,8,0.875,0.125,0,1,1,0,1,0,0,0,NA,NA
"212","98388",6,11,17,0.352941176470588,0.647058823529412,2,2,4,0.5,0.5,0,2,2,0,1,0,0,0,NA,NA
"213","98390",4,8,12,0.333333333333333,0.666666666666667,1,3,4,0.75,0.25,0,1,1,0,1,0,0,0,NA,NA
"214","98391",25,54,79,0.316455696202532,0.683544303797468,5,17,22,0.772727272727273,0.227272727272727,1,4,5,0.2,0.8,0,0,0,NA,NA
"215","98392",1,2,3,0.333333333333333,0.666666666666667,0,1,1,1,0,0,0,0,NA,NA,0,0,0,NA,NA
"216","98393",2,0,2,1,0,1,0,1,0,1,0,0,0,NA,NA,0,0,0,NA,NA
"217","98394",1,1,2,0.5,0.5,0,0,0,NA,NA,0,0,0,NA,NA,0,0,0,NA,NA
"218","98403",4,13,17,0.235294117647059,0.764705882352941,1,5,6,0.833333333333333,0.166666666666667,0,1,1,0,1,0,0,0,NA,NA
"219","98404",4,20,24,0.166666666666667,0.833333333333333,1,2,3,0.666666666666667,0.333333333333333,0,1,1,0,1,0,0,0,NA,NA
"220","98405",3,14,17,0.176470588235294,0.823529411764706,1,5,6,0.833333333333333,0.166666666666667,0,0,0,NA,NA,0,0,0,NA,NA
"221","98406",21,22,43,0.488372093023256,0.511627906976744,5,6,11,0.545454545454545,0.454545454545455,1,1,2,0.5,0.5,0,0,0,NA,NA
"222","98407",9,29,38,0.236842105263158,0.763157894736842,3,13,16,0.8125,0.1875,0,4,4,0,1,0,0,0,NA,NA
"223","98408",6,16,22,0.272727272727273,0.727272727272727,3,8,11,0.727272727272727,0.272727272727273,0,1,1,0,1,0,0,0,NA,NA
"224","98409",11,9,20,0.55,0.45,6,2,8,0.25,0.75,0,0,0,NA,NA,0,0,0,NA,NA
"225","98411",0,1,1,0,1,0,1,1,1,0,0,0,0,NA,NA,0,0,0,NA,NA
"226","98412",1,1,2,0.5,0.5,1,0,1,0,1,0,0,0,NA,NA,0,0,0,NA,NA
"227","98415",0,2,2,0,1,0,0,0,NA,NA,0,0,0,NA,NA,0,0,0,NA,NA
"228","98417",0,1,1,0,1,0,1,1,1,0,0,0,0,NA,NA,0,0,0,NA,NA
"229","98418",0,3,3,0,1,0,2,2,1,0,0,0,0,NA,NA,0,0,0,NA,NA
"230","98419",0,1,1,0,1,0,0,0,NA,NA,0,0,0,NA,NA,0,0,0,NA,NA
"231","98422",13,20,33,0.393939393939394,0.606060606060606,6,5,11,0.454545454545455,0.545454545454545,0,2,2,0,1,0,0,0,NA,NA
"232","98424",3,3,6,0.5,0.5,2,0,2,0,1,2,0,2,1,0,1,1,2,0.5,0.5
"233","98433",1,5,6,0.166666666666667,0.833333333333333,0,0,0,NA,NA,0,0,0,NA,NA,0,0,0,NA,NA
"234","98439",0,4,4,0,1,0,1,1,1,0,0,0,0,NA,NA,0,0,0,NA,NA
"235","98443",3,4,7,0.428571428571429,0.571428571428571,1,1,2,0.5,0.5,1,0,1,1,0,0,0,0,NA,NA
"236","98444",5,21,26,0.192307692307692,0.807692307692308,0,2,2,1,0,0,0,0,NA,NA,0,0,0,NA,NA
"237","98445",9,15,24,0.375,0.625,1,1,2,0.5,0.5,1,1,2,0.5,0.5,0,0,0,NA,NA
"238","98446",3,12,15,0.2,0.8,1,2,3,0.666666666666667,0.333333333333333,0,0,0,NA,NA,0,0,0,NA,NA
"239","98448",0,2,2,0,1,0,1,1,1,0,0,0,0,NA,NA,0,0,0,NA,NA
"240","98464",0,2,2,0,1,0,0,0,NA,NA,0,0,0,NA,NA,0,0,0,NA,NA
"241","98465",2,10,12,0.166666666666667,0.833333333333333,2,4,6,0.666666666666667,0.333333333333333,0,1,1,0,1,0,0,0,NA,NA
"242","98466",24,31,55,0.436363636363636,0.563636363636364,9,17,26,0.653846153846154,0.346153846153846,2,2,4,0.5,0.5,0,0,0,NA,NA
"243","98467",6,37,43,0.139534883720930,0.86046511627907,1,11,12,0.916666666666667,0.0833333333333333,0,4,4,0,1,0,0,0,NA,NA
"244","98496",1,0,1,1,0,1,0,1,0,1,0,0,0,NA,NA,0,0,0,NA,NA
"245","98498",15,24,39,0.384615384615385,0.615384615384615,6,6,12,0.5,0.5,0,1,1,0,1,0,0,0,NA,NA
"246","98499",10,15,25,0.4,0.6,4,3,7,0.428571428571429,0.571428571428571,0,1,1,0,1,0,0,0,NA,NA
"247","98501",36,58,94,0.382978723404255,0.617021276595745,13,23,36,0.638888888888889,0.361111111111111,7,9,16,0.4375,0.5625,3,3,6,0.5,0.5
"248","98502",29,29,58,0.5,0.5,5,16,21,0.761904761904762,0.238095238095238,1,4,5,0.2,0.8,0,0,0,NA,NA
"249","98503",13,21,34,0.382352941176471,0.617647058823529,2,1,3,0.333333333333333,0.666666666666667,0,0,0,NA,NA,0,0,0,NA,NA
"250","98505",1,1,2,0.5,0.5,1,0,1,0,1,0,0,0,NA,NA,0,0,0,NA,NA
"251","98506",12,20,32,0.375,0.625,6,7,13,0.538461538461538,0.461538461538462,1,1,2,0.5,0.5,0,0,0,NA,NA
"252","98507",0,4,4,0,1,0,0,0,NA,NA,0,0,0,NA,NA,0,0,0,NA,NA
"253","98508",1,0,1,1,0,0,0,0,NA,NA,0,0,0,NA,NA,0,0,0,NA,NA
"254","98509",3,1,4,0.75,0.25,1,1,2,0.5,0.5,0,0,0,NA,NA,0,0,0,NA,NA
"255","98512",16,22,38,0.421052631578947,0.578947368421053,4,8,12,0.666666666666667,0.333333333333333,0,3,3,0,1,0,0,0,NA,NA
"256","98513",15,31,46,0.326086956521739,0.673913043478261,5,8,13,0.615384615384615,0.384615384615385,0,2,2,0,1,0,0,0,NA,NA
"257","98516",10,17,27,0.370370370370370,0.62962962962963,3,4,7,0.571428571428571,0.428571428571429,0,0,0,NA,NA,0,0,0,NA,NA
"258","98520",6,21,27,0.222222222222222,0.777777777777778,1,4,5,0.8,0.2,0,1,1,0,1,0,0,0,NA,NA
"259","98524",2,5,7,0.285714285714286,0.714285714285714,0,2,2,1,0,0,0,0,NA,NA,0,0,0,NA,NA
"260","98528",1,17,18,0.0555555555555556,0.944444444444444,1,8,9,0.888888888888889,0.111111111111111,0,0,0,NA,NA,0,0,0,NA,NA
"261","98531",3,18,21,0.142857142857143,0.857142857142857,0,7,7,1,0,0,2,2,0,1,0,0,0,NA,NA
"262","98532",2,10,12,0.166666666666667,0.833333333333333,0,1,1,1,0,0,0,0,NA,NA,0,0,0,NA,NA
"263","98536",1,0,1,1,0,0,0,0,NA,NA,0,0,0,NA,NA,0,0,0,NA,NA
"264","98537",0,1,1,0,1,0,0,0,NA,NA,0,0,0,NA,NA,0,0,0,NA,NA
"265","98540",0,1,1,0,1,0,0,0,NA,NA,0,0,0,NA,NA,0,0,0,NA,NA
"266","98541",1,2,3,0.333333333333333,0.666666666666667,0,0,0,NA,NA,0,0,0,NA,NA,0,0,0,NA,NA
"267","98542",1,0,1,1,0,1,0,1,0,1,0,0,0,NA,NA,0,0,0,NA,NA
"268","98547",0,1,1,0,1,0,0,0,NA,NA,0,0,0,NA,NA,0,0,0,NA,NA
"269","98550",4,13,17,0.235294117647059,0.764705882352941,1,2,3,0.666666666666667,0.333333333333333,0,0,0,NA,NA,0,0,0,NA,NA
"270","98554",0,1,1,0,1,0,1,1,1,0,0,0,0,NA,NA,0,0,0,NA,NA
"271","98558",0,1,1,0,1,0,0,0,NA,NA,0,0,0,NA,NA,0,0,0,NA,NA
"272","98559",0,1,1,0,1,0,0,0,NA,NA,0,0,0,NA,NA,0,0,0,NA,NA
"273","98563",4,4,8,0.5,0.5,1,1,2,0.5,0.5,0,0,0,NA,NA,0,0,0,NA,NA
"274","98564",0,4,4,0,1,0,1,1,1,0,0,0,0,NA,NA,0,0,0,NA,NA
"275","98565",1,2,3,0.333333333333333,0.666666666666667,0,0,0,NA,NA,0,0,0,NA,NA,0,0,0,NA,NA
"276","98568",0,2,2,0,1,0,0,0,NA,NA,0,0,0,NA,NA,0,0,0,NA,NA
"277","98569",1,0,1,1,0,0,0,0,NA,NA,0,0,0,NA,NA,0,0,0,NA,NA
"278","98570",1,3,4,0.25,0.75,1,3,4,0.75,0.25,0,0,0,NA,NA,0,0,0,NA,NA
"279","98576",2,6,8,0.25,0.75,1,2,3,0.666666666666667,0.333333333333333,0,0,0,NA,NA,0,0,0,NA,NA
"280","98577",1,5,6,0.166666666666667,0.833333333333333,0,0,0,NA,NA,0,0,0,NA,NA,0,0,0,NA,NA
"281","98579",1,3,4,0.25,0.75,0,0,0,NA,NA,0,0,0,NA,NA,0,0,0,NA,NA
"282","98580",6,5,11,0.545454545454545,0.454545454545455,3,1,4,0.25,0.75,1,0,1,1,0,0,0,0,NA,NA
"283","98582",1,1,2,0.5,0.5,0,0,0,NA,NA,0,0,0,NA,NA,0,0,0,NA,NA
"284","98584",2,10,12,0.166666666666667,0.833333333333333,1,2,3,0.666666666666667,0.333333333333333,0,0,0,NA,NA,0,0,0,NA,NA
"285","98586",2,0,2,1,0,0,0,0,NA,NA,0,0,0,NA,NA,0,0,0,NA,NA
"286","98588",0,4,4,0,1,0,0,0,NA,NA,0,0,0,NA,NA,0,0,0,NA,NA
"287","98589",3,6,9,0.333333333333333,0.666666666666667,2,3,5,0.6,0.4,0,1,1,0,1,0,0,0,NA,NA
"288","98590",0,1,1,0,1,0,0,0,NA,NA,0,0,0,NA,NA,0,0,0,NA,NA
"289","98591",2,4,6,0.333333333333333,0.666666666666667,1,2,3,0.666666666666667,0.333333333333333,0,0,0,NA,NA,0,0,0,NA,NA
"290","98593",1,2,3,0.333333333333333,0.666666666666667,0,0,0,NA,NA,0,0,0,NA,NA,0,0,0,NA,NA
"291","98595",0,4,4,0,1,0,0,0,NA,NA,0,0,0,NA,NA,0,0,0,NA,NA
"292","98596",2,8,10,0.2,0.8,1,2,3,0.666666666666667,0.333333333333333,0,0,0,NA,NA,0,0,0,NA,NA
"293","98597",4,10,14,0.285714285714286,0.714285714285714,2,3,5,0.6,0.4,0,0,0,NA,NA,0,0,0,NA,NA
"294","98601",2,1,3,0.666666666666667,0.333333333333333,0,0,0,NA,NA,0,0,0,NA,NA,0,0,0,NA,NA
"295","98603",0,1,1,0,1,0,0,0,NA,NA,0,0,0,NA,NA,0,0,0,NA,NA
"296","98604",15,20,35,0.428571428571429,0.571428571428571,7,8,15,0.533333333333333,0.466666666666667,3,3,6,0.5,0.5,2,2,4,0.5,0.5
"297","98605",1,0,1,1,0,0,0,0,NA,NA,0,0,0,NA,NA,0,0,0,NA,NA
"298","98606",13,12,25,0.52,0.48,4,6,10,0.6,0.4,2,1,3,0.666666666666667,0.333333333333333,1,1,2,0.5,0.5
"299","98607",18,25,43,0.418604651162791,0.581395348837209,4,10,14,0.714285714285714,0.285714285714286,1,4,5,0.2,0.8,1,1,2,0.5,0.5
"300","98610",1,3,4,0.25,0.75,1,1,2,0.5,0.5,0,0,0,NA,NA,0,0,0,NA,NA
"301","98611",4,6,10,0.4,0.6,2,0,2,0,1,0,0,0,NA,NA,0,0,0,NA,NA
"302","98612",0,3,3,0,1,0,2,2,1,0,0,0,0,NA,NA,0,0,0,NA,NA
"303","98613",1,0,1,1,0,1,0,1,0,1,1,0,1,1,0,1,1,2,0.5,0.5
"304","98617",0,1,1,0,1,0,0,0,NA,NA,0,0,0,NA,NA,0,0,0,NA,NA
"305","98619",0,1,1,0,1,0,0,0,NA,NA,0,0,0,NA,NA,0,0,0,NA,NA
"306","98620",3,4,7,0.428571428571429,0.571428571428571,1,0,1,0,1,0,0,0,NA,NA,0,0,0,NA,NA
"307","98623",0,0,0,NA,NA,0,0,0,NA,NA,0,0,0,NA,NA,0,0,0,NA,NA
"308","98624",2,0,2,1,0,2,0,2,0,1,0,0,0,NA,NA,0,0,0,NA,NA
"309","98625",6,4,10,0.6,0.4,3,2,5,0.4,0.6,0,1,1,0,1,0,0,0,NA,NA
"310","98626",13,16,29,0.448275862068966,0.551724137931034,4,1,5,0.2,0.8,1,1,2,0.5,0.5,1,1,2,0.5,0.5
"311","98629",7,9,16,0.4375,0.5625,1,0,1,0,1,0,0,0,NA,NA,0,0,0,NA,NA
"312","98631",0,1,1,0,1,0,0,0,NA,NA,0,0,0,NA,NA,0,0,0,NA,NA
"313","98632",18,28,46,0.391304347826087,0.608695652173913,6,8,14,0.571428571428571,0.428571428571429,0,1,1,0,1,0,0,0,NA,NA
"314","98635",0,1,1,0,1,0,0,0,NA,NA,0,0,0,NA,NA,0,0,0,NA,NA
"315","98637",1,0,1,1,0,0,0,0,NA,NA,0,0,0,NA,NA,0,0,0,NA,NA
"316","98638",1,2,3,0.333333333333333,0.666666666666667,0,0,0,NA,NA,0,0,0,NA,NA,0,0,0,NA,NA
"317","98642",8,20,28,0.285714285714286,0.714285714285714,5,9,14,0.642857142857143,0.357142857142857,3,2,5,0.6,0.4,3,3,6,0.5,0.5
"318","98644",0,1,1,0,1,0,0,0,NA,NA,0,0,0,NA,NA,0,0,0,NA,NA
"319","98645",1,3,4,0.25,0.75,0,1,1,1,0,0,1,1,0,1,0,0,0,NA,NA
"320","98647",0,1,1,0,1,0,0,0,NA,NA,0,0,0,NA,NA,0,0,0,NA,NA
"321","98648",0,2,2,0,1,0,0,0,NA,NA,0,0,0,NA,NA,0,0,0,NA,NA
"322","98649",0,1,1,0,1,0,1,1,1,0,0,0,0,NA,NA,0,0,0,NA,NA
"323","98650",0,1,1,0,1,0,0,0,NA,NA,0,0,0,NA,NA,0,0,0,NA,NA
"324","98651",0,1,1,0,1,0,0,0,NA,NA,0,0,0,NA,NA,0,0,0,NA,NA
"325","98660",5,5,10,0.5,0.5,0,0,0,NA,NA,0,0,0,NA,NA,0,0,0,NA,NA
"326","98661",14,27,41,0.341463414634146,0.658536585365854,2,12,14,0.857142857142857,0.142857142857143,2,3,5,0.4,0.6,1,1,2,0.5,0.5
"327","98662",11,25,36,0.305555555555556,0.694444444444444,5,11,16,0.6875,0.3125,1,2,3,0.333333333333333,0.666666666666667,1,1,2,0.5,0.5
"328","98663",9,11,20,0.45,0.55,6,5,11,0.454545454545455,0.545454545454545,1,0,1,1,0,1,1,2,0.5,0.5
"329","98664",14,16,30,0.466666666666667,0.533333333333333,3,6,9,0.666666666666667,0.333333333333333,2,4,6,0.333333333333333,0.666666666666667,1,1,2,0.5,0.5
"330","98665",8,30,38,0.210526315789474,0.789473684210526,2,12,14,0.857142857142857,0.142857142857143,0,3,3,0,1,0,0,0,NA,NA
"331","98668",0,1,1,0,1,0,0,0,NA,NA,0,0,0,NA,NA,0,0,0,NA,NA
"332","98671",11,16,27,0.407407407407407,0.592592592592593,5,3,8,0.375,0.625,2,0,2,1,0,1,1,2,0.5,0.5
"333","98672",3,5,8,0.375,0.625,0,0,0,NA,NA,0,0,0,NA,NA,0,0,0,NA,NA
"334","98674",5,19,24,0.208333333333333,0.791666666666667,2,7,9,0.777777777777778,0.222222222222222,2,1,3,0.666666666666667,0.333333333333333,1,1,2,0.5,0.5
"335","98682",33,49,82,0.402439024390244,0.597560975609756,16,19,35,0.542857142857143,0.457142857142857,4,2,6,0.666666666666667,0.333333333333333,2,2,4,0.5,0.5
"336","98683",20,30,50,0.4,0.6,9,11,20,0.55,0.45,3,3,6,0.5,0.5,2,2,4,0.5,0.5
"337","98684",8,19,27,0.296296296296296,0.703703703703704,3,8,11,0.727272727272727,0.272727272727273,1,0,1,1,0,0,0,0,NA,NA
"338","98685",33,40,73,0.452054794520548,0.547945205479452,16,21,37,0.567567567567568,0.432432432432432,2,6,8,0.25,0.75,1,1,2,0.5,0.5
"339","98686",7,18,25,0.28,0.72,2,9,11,0.818181818181818,0.181818181818182,0,3,3,0,1,0,0,0,NA,NA
"340","98687",0,1,1,0,1,0,1,1,1,0,0,0,0,NA,NA,0,0,0,NA,NA
"341","98801",10,18,28,0.357142857142857,0.642857142857143,3,9,12,0.75,0.25,0,2,2,0,1,0,0,0,NA,NA
"342","98802",5,6,11,0.454545454545455,0.545454545454545,0,0,0,NA,NA,0,0,0,NA,NA,0,0,0,NA,NA
"343","98807",0,1,1,0,1,0,0,0,NA,NA,0,0,0,NA,NA,0,0,0,NA,NA
"344","98812",0,1,1,0,1,0,0,0,NA,NA,0,0,0,NA,NA,0,0,0,NA,NA
"345","98815",1,1,2,0.5,0.5,1,0,1,0,1,0,0,0,NA,NA,0,0,0,NA,NA
"346","98816",2,4,6,0.333333333333333,0.666666666666667,1,4,5,0.8,0.2,0,2,2,0,1,0,0,0,NA,NA
"347","98823",1,0,1,1,0,0,0,0,NA,NA,0,0,0,NA,NA,0,0,0,NA,NA
"348","98826",0,1,1,0,1,0,0,0,NA,NA,0,0,0,NA,NA,0,0,0,NA,NA
"349","98831",0,3,3,0,1,0,0,0,NA,NA,0,0,0,NA,NA,0,0,0,NA,NA
"350","98837",2,6,8,0.25,0.75,1,0,1,0,1,0,0,0,NA,NA,0,0,0,NA,NA
"351","98841",1,2,3,0.333333333333333,0.666666666666667,1,1,2,0.5,0.5,1,0,1,1,0,0,0,0,NA,NA
"352","98844",1,0,1,1,0,0,0,0,NA,NA,0,0,0,NA,NA,0,0,0,NA,NA
"353","98848",1,3,4,0.25,0.75,0,0,0,NA,NA,0,0,0,NA,NA,0,0,0,NA,NA
"354","98855",1,0,1,1,0,0,0,0,NA,NA,0,0,0,NA,NA,0,0,0,NA,NA
"355","98857",1,0,1,1,0,0,0,0,NA,NA,0,0,0,NA,NA,0,0,0,NA,NA
"356","98858",1,0,1,1,0,0,0,0,NA,NA,0,0,0,NA,NA,0,0,0,NA,NA
"357","98862",2,3,5,0.4,0.6,1,1,2,0.5,0.5,0,1,1,0,1,0,0,0,NA,NA
"358","98901",5,7,12,0.416666666666667,0.583333333333333,1,2,3,0.666666666666667,0.333333333333333,0,0,0,NA,NA,0,0,0,NA,NA
"359","98902",8,14,22,0.363636363636364,0.636363636363636,1,1,2,0.5,0.5,1,0,1,1,0,1,1,2,0.5,0.5
"360","98903",3,2,5,0.6,0.4,0,1,1,1,0,0,0,0,NA,NA,0,0,0,NA,NA
"361","98907",0,1,1,0,1,0,1,1,1,0,0,1,1,0,1,0,0,0,NA,NA
"362","98908",12,22,34,0.352941176470588,0.647058823529412,7,9,16,0.5625,0.4375,4,5,9,0.444444444444444,0.555555555555556,2,2,4,0.5,0.5
"363","98926",3,7,10,0.3,0.7,0,3,3,1,0,0,1,1,0,1,0,0,0,NA,NA
"364","98930",2,2,4,0.5,0.5,0,1,1,1,0,0,0,0,NA,NA,0,0,0,NA,NA
"365","98932",0,0,0,NA,NA,0,0,0,NA,NA,0,0,0,NA,NA,0,0,0,NA,NA
"366","98933",0,2,2,0,1,0,1,1,1,0,0,0,0,NA,NA,0,0,0,NA,NA
"367","98935",0,3,3,0,1,0,1,1,1,0,0,0,0,NA,NA,0,0,0,NA,NA
"368","98936",0,3,3,0,1,0,1,1,1,0,0,0,0,NA,NA,0,0,0,NA,NA
"369","98937",2,0,2,1,0,0,0,0,NA,NA,0,0,0,NA,NA,0,0,0,NA,NA
"370","98938",1,1,2,0.5,0.5,1,0,1,0,1,1,0,1,1,0,0,0,0,NA,NA
"371","98942",3,6,9,0.333333333333333,0.666666666666667,0,3,3,1,0,0,1,1,0,1,0,0,0,NA,NA
"372","98944",2,5,7,0.285714285714286,0.714285714285714,0,2,2,1,0,0,0,0,NA,NA,0,0,0,NA,NA
"373","98948",2,6,8,0.25,0.75,0,2,2,1,0,0,2,2,0,1,0,0,0,NA,NA
"374","98951",4,3,7,0.571428571428571,0.428571428571429,0,0,0,NA,NA,0,0,0,NA,NA,0,0,0,NA,NA
"375","98953",0,1,1,0,1,0,0,0,NA,NA,0,0,0,NA,NA,0,0,0,NA,NA
"376","99001",0,2,2,0,1,0,1,1,1,0,0,0,0,NA,NA,0,0,0,NA,NA
"377","99003",2,0,2,1,0,0,0,0,NA,NA,0,0,0,NA,NA,0,0,0,NA,NA
"378","99004",5,7,12,0.416666666666667,0.583333333333333,1,2,3,0.666666666666667,0.333333333333333,0,0,0,NA,NA,0,0,0,NA,NA
"379","99005",3,9,12,0.25,0.75,2,4,6,0.666666666666667,0.333333333333333,1,0,1,1,0,1,1,2,0.5,0.5
"380","99006",1,5,6,0.166666666666667,0.833333333333333,0,1,1,1,0,0,0,0,NA,NA,0,0,0,NA,NA
"381","99009",0,1,1,0,1,0,0,0,NA,NA,0,0,0,NA,NA,0,0,0,NA,NA
"382","99012",0,1,1,0,1,0,0,0,NA,NA,0,0,0,NA,NA,0,0,0,NA,NA
"383","99014",1,1,2,0.5,0.5,0,0,0,NA,NA,0,0,0,NA,NA,0,0,0,NA,NA
"384","99016",1,8,9,0.111111111111111,0.888888888888889,0,3,3,1,0,0,2,2,0,1,0,0,0,NA,NA
"385","99019",4,3,7,0.571428571428571,0.428571428571429,1,2,3,0.666666666666667,0.333333333333333,0,0,0,NA,NA,0,0,0,NA,NA
"386","99021",4,2,6,0.666666666666667,0.333333333333333,2,0,2,0,1,0,0,0,NA,NA,0,0,0,NA,NA
"387","99022",3,2,5,0.6,0.4,0,0,0,NA,NA,0,0,0,NA,NA,0,0,0,NA,NA
"388","99025",2,1,3,0.666666666666667,0.333333333333333,1,0,1,0,1,0,0,0,NA,NA,0,0,0,NA,NA
"389","99026",1,2,3,0.333333333333333,0.666666666666667,1,0,1,0,1,1,0,1,1,0,0,0,0,NA,NA
"390","99027",1,2,3,0.333333333333333,0.666666666666667,0,0,0,NA,NA,0,0,0,NA,NA,0,0,0,NA,NA
"391","99031",0,1,1,0,1,0,0,0,NA,NA,0,0,0,NA,NA,0,0,0,NA,NA
"392","99037",4,11,15,0.266666666666667,0.733333333333333,1,3,4,0.75,0.25,0,0,0,NA,NA,0,0,0,NA,NA
"393","99109",1,1,2,0.5,0.5,1,0,1,0,1,0,0,0,NA,NA,0,0,0,NA,NA
"394","99111",1,1,2,0.5,0.5,0,0,0,NA,NA,0,0,0,NA,NA,0,0,0,NA,NA
"395","99114",2,3,5,0.4,0.6,0,0,0,NA,NA,0,0,0,NA,NA,0,0,0,NA,NA
"396","99122",0,2,2,0,1,0,1,1,1,0,0,0,0,NA,NA,0,0,0,NA,NA
"397","99129",0,1,1,0,1,0,1,1,1,0,0,0,0,NA,NA,0,0,0,NA,NA
"398","99133",0,1,1,0,1,0,0,0,NA,NA,0,0,0,NA,NA,0,0,0,NA,NA
"399","99141",0,2,2,0,1,0,1,1,1,0,0,1,1,0,1,0,0,0,NA,NA
"400","99156",4,4,8,0.5,0.5,1,0,1,0,1,0,0,0,NA,NA,0,0,0,NA,NA
"401","99158",1,0,1,1,0,0,0,0,NA,NA,0,0,0,NA,NA,0,0,0,NA,NA
"402","99159",0,1,1,0,1,0,0,0,NA,NA,0,0,0,NA,NA,0,0,0,NA,NA
"403","99161",1,0,1,1,0,0,0,0,NA,NA,0,0,0,NA,NA,0,0,0,NA,NA
"404","99163",2,7,9,0.222222222222222,0.777777777777778,0,2,2,1,0,0,0,0,NA,NA,0,0,0,NA,NA
"405","99170",0,1,1,0,1,0,0,0,NA,NA,0,0,0,NA,NA,0,0,0,NA,NA
"406","99181",1,0,1,1,0,0,0,0,NA,NA,0,0,0,NA,NA,0,0,0,NA,NA
"407","99201",1,0,1,1,0,0,0,0,NA,NA,0,0,0,NA,NA,0,0,0,NA,NA
"408","99202",2,3,5,0.4,0.6,1,0,1,0,1,1,0,1,1,0,0,0,0,NA,NA
"409","99203",9,20,29,0.310344827586207,0.689655172413793,5,6,11,0.545454545454545,0.454545454545455,3,4,7,0.428571428571429,0.571428571428571,1,1,2,0.5,0.5
"410","99204",1,0,1,1,0,0,0,0,NA,NA,0,0,0,NA,NA,0,0,0,NA,NA
"411","99205",7,9,16,0.4375,0.5625,0,2,2,1,0,0,1,1,0,1,0,0,0,NA,NA
"412","99206",10,6,16,0.625,0.375,2,0,2,0,1,0,0,0,NA,NA,0,0,0,NA,NA
"413","99207",4,5,9,0.444444444444444,0.555555555555556,3,2,5,0.4,0.6,2,2,4,0.5,0.5,0,0,0,NA,NA
"414","99208",23,26,49,0.469387755102041,0.530612244897959,12,14,26,0.538461538461538,0.461538461538462,3,2,5,0.6,0.4,3,3,6,0.5,0.5
"415","99210",0,1,1,0,1,0,0,0,NA,NA,0,0,0,NA,NA,0,0,0,NA,NA
"416","99212",4,2,6,0.666666666666667,0.333333333333333,2,0,2,0,1,0,0,0,NA,NA,0,0,0,NA,NA
"417","99216",4,6,10,0.4,0.6,0,3,3,1,0,0,0,0,NA,NA,0,0,0,NA,NA
"418","99217",2,5,7,0.285714285714286,0.714285714285714,0,0,0,NA,NA,0,0,0,NA,NA,0,0,0,NA,NA
"419","99218",2,5,7,0.285714285714286,0.714285714285714,1,2,3,0.666666666666667,0.333333333333333,0,1,1,0,1,0,0,0,NA,NA
"420","99223",17,34,51,0.333333333333333,0.666666666666667,6,18,24,0.75,0.25,2,7,9,0.222222222222222,0.777777777777778,1,1,2,0.5,0.5
"421","99224",2,3,5,0.4,0.6,2,1,3,0.333333333333333,0.666666666666667,0,1,1,0,1,0,0,0,NA,NA
"422","99228",0,1,1,0,1,0,0,0,NA,NA,0,0,0,NA,NA,0,0,0,NA,NA
"423","99258",1,1,2,0.5,0.5,1,1,2,0.5,0.5,0,0,0,NA,NA,0,0,0,NA,NA
"424","99301",12,17,29,0.413793103448276,0.586206896551724,3,7,10,0.7,0.3,1,2,3,0.333333333333333,0.666666666666667,0,0,0,NA,NA
"425","99302",0,1,1,0,1,0,1,1,1,0,0,1,1,0,1,0,0,0,NA,NA
"426","99320",1,1,2,0.5,0.5,0,1,1,1,0,0,0,0,NA,NA,0,0,0,NA,NA
"427","99323",0,1,1,0,1,0,0,0,NA,NA,0,0,0,NA,NA,0,0,0,NA,NA
"428","99324",1,2,3,0.333333333333333,0.666666666666667,0,1,1,1,0,0,0,0,NA,NA,0,0,0,NA,NA
"429","99336",7,18,25,0.28,0.72,2,3,5,0.6,0.4,0,0,0,NA,NA,0,0,0,NA,NA
"430","99337",6,16,22,0.272727272727273,0.727272727272727,5,3,8,0.375,0.625,1,0,1,1,0,1,1,2,0.5,0.5
"431","99338",4,4,8,0.5,0.5,0,3,3,1,0,0,0,0,NA,NA,0,0,0,NA,NA
"432","99341",0,0,0,NA,NA,0,0,0,NA,NA,0,0,0,NA,NA,0,0,0,NA,NA
"433","99343",0,2,2,0,1,0,0,0,NA,NA,0,0,0,NA,NA,0,0,0,NA,NA
"434","99344",1,3,4,0.25,0.75,0,0,0,NA,NA,0,0,0,NA,NA,0,0,0,NA,NA
"435","99348",1,0,1,1,0,0,0,0,NA,NA,0,0,0,NA,NA,0,0,0,NA,NA
"436","99349",2,1,3,0.666666666666667,0.333333333333333,0,0,0,NA,NA,0,0,0,NA,NA,0,0,0,NA,NA
"437","99350",1,4,5,0.2,0.8,0,1,1,1,0,0,0,0,NA,NA,0,0,0,NA,NA
"438","99352",9,16,25,0.36,0.64,2,5,7,0.714285714285714,0.285714285714286,2,2,4,0.5,0.5,1,1,2,0.5,0.5
"439","99353",2,5,7,0.285714285714286,0.714285714285714,2,2,4,0.5,0.5,2,0,2,1,0,1,1,2,0.5,0.5
"440","99354",7,13,20,0.35,0.65,4,4,8,0.5,0.5,2,1,3,0.666666666666667,0.333333333333333,0,0,0,NA,NA
"441","99357",1,0,1,1,0,0,0,0,NA,NA,0,0,0,NA,NA,0,0,0,NA,NA
"442","99360",0,2,2,0,1,0,0,0,NA,NA,0,0,0,NA,NA,0,0,0,NA,NA
"443","99361",1,0,1,1,0,0,0,0,NA,NA,0,0,0,NA,NA,0,0,0,NA,NA
"444","99362",13,29,42,0.309523809523810,0.69047619047619,3,11,14,0.785714285714286,0.214285714285714,0,2,2,0,1,0,0,0,NA,NA
"445","99402",0,1,1,0,1,0,0,0,NA,NA,0,0,0,NA,NA,0,0,0,NA,NA
"446","99403",2,5,7,0.285714285714286,0.714285714285714,0,0,0,NA,NA,0,0,0,NA,NA,0,0,0,NA,NA
