"","Zipcodes","InquiryMale","InquiryFemale","InquiryTotal","InquiryMalePercentage","InquiryFemalePercentage","AppliedMale","AppliedFemale","AppliedTotal","AppliedMalePercentage","AppliedFemalePercentage","AcceptedMale","AcceptedFemale","AcceptedTotal","AcceptedMalePercentage","AcceptedFemalePercentage","EnrolledMale","EnrolledFemale","EnrolledTotal","EnrolledMalePercentage","EnrolledFemalePercentage"
"1","98001",23,25,48,0.479166666666667,0.520833333333333,9,12,21,0.571428571428571,0.428571428571429,3,5,8,0.375,0.625,0,0,0,NA,NA
"2","98002",3,16,19,0.157894736842105,0.842105263157895,1,4,5,0.8,0.2,0,1,1,0,1,0,0,0,NA,NA
"3","98003",16,34,50,0.32,0.68,6,15,21,0.714285714285714,0.285714285714286,1,3,4,0.25,0.75,0,0,0,NA,NA
"4","98004",23,28,51,0.450980392156863,0.549019607843137,13,15,28,0.535714285714286,0.464285714285714,4,6,10,0.4,0.6,1,1,2,0.5,0.5
"5","98005",15,17,32,0.46875,0.53125,9,5,14,0.357142857142857,0.642857142857143,2,2,4,0.5,0.5,1,1,2,0.5,0.5
"6","98006",55,69,124,0.443548387096774,0.556451612903226,20,18,38,0.473684210526316,0.526315789473684,7,2,9,0.777777777777778,0.222222222222222,4,4,8,0.5,0.5
"7","98007",10,17,27,0.370370370370370,0.62962962962963,1,3,4,0.75,0.25,0,0,0,NA,NA,0,0,0,NA,NA
"8","98008",20,21,41,0.48780487804878,0.51219512195122,8,6,14,0.428571428571429,0.571428571428571,2,2,4,0.5,0.5,1,1,2,0.5,0.5
"9","98009",1,1,2,0.5,0.5,1,0,1,0,1,1,0,1,1,0,1,1,2,0.5,0.5
"10","98010",4,6,10,0.4,0.6,2,3,5,0.6,0.4,0,0,0,NA,NA,0,0,0,NA,NA
"11","98011",13,31,44,0.295454545454545,0.704545454545455,4,13,17,0.764705882352941,0.235294117647059,2,4,6,0.333333333333333,0.666666666666667,0,0,0,NA,NA
"12","98012",30,43,73,0.410958904109589,0.589041095890411,10,19,29,0.655172413793103,0.344827586206897,3,5,8,0.375,0.625,1,1,2,0.5,0.5
"13","98014",7,7,14,0.5,0.5,2,2,4,0.5,0.5,1,1,2,0.5,0.5,1,1,2,0.5,0.5
"14","98019",5,8,13,0.384615384615385,0.615384615384615,2,1,3,0.333333333333333,0.666666666666667,1,0,1,1,0,0,0,0,NA,NA
"15","98020",15,31,46,0.326086956521739,0.673913043478261,10,17,27,0.62962962962963,0.370370370370370,4,8,12,0.333333333333333,0.666666666666667,0,0,0,NA,NA
"16","98021",10,37,47,0.212765957446809,0.787234042553192,6,15,21,0.714285714285714,0.285714285714286,3,7,10,0.3,0.7,0,0,0,NA,NA
"17","98022",11,28,39,0.282051282051282,0.717948717948718,4,12,16,0.75,0.25,0,3,3,0,1,0,0,0,NA,NA
"18","98023",40,69,109,0.36697247706422,0.63302752293578,16,28,44,0.636363636363636,0.363636363636364,2,9,11,0.181818181818182,0.818181818181818,0,0,0,NA,NA
"19","98024",4,10,14,0.285714285714286,0.714285714285714,1,1,2,0.5,0.5,1,1,2,0.5,0.5,1,1,2,0.5,0.5
"20","98025",0,1,1,0,1,0,1,1,1,0,0,0,0,NA,NA,0,0,0,NA,NA
"21","98026",27,39,66,0.409090909090909,0.590909090909091,11,18,29,0.620689655172414,0.379310344827586,2,6,8,0.25,0.75,2,2,4,0.5,0.5
"22","98027",24,49,73,0.328767123287671,0.671232876712329,9,21,30,0.7,0.3,1,6,7,0.142857142857143,0.857142857142857,0,0,0,NA,NA
"23","98028",12,19,31,0.387096774193548,0.612903225806452,5,10,15,0.666666666666667,0.333333333333333,1,2,3,0.333333333333333,0.666666666666667,0,0,0,NA,NA
"24","98029",13,21,34,0.382352941176471,0.617647058823529,6,11,17,0.647058823529412,0.352941176470588,2,3,5,0.4,0.6,0,0,0,NA,NA
"25","98030",13,10,23,0.565217391304348,0.434782608695652,4,2,6,0.333333333333333,0.666666666666667,1,0,1,1,0,1,1,2,0.5,0.5
"26","98031",8,34,42,0.190476190476190,0.80952380952381,4,14,18,0.777777777777778,0.222222222222222,1,3,4,0.25,0.75,0,0,0,NA,NA
"27","98032",7,13,20,0.35,0.65,3,6,9,0.666666666666667,0.333333333333333,1,2,3,0.333333333333333,0.666666666666667,0,0,0,NA,NA
"28","98033",15,19,34,0.441176470588235,0.558823529411765,8,4,12,0.333333333333333,0.666666666666667,1,2,3,0.333333333333333,0.666666666666667,0,0,0,NA,NA
"29","98034",25,19,44,0.568181818181818,0.431818181818182,11,8,19,0.421052631578947,0.578947368421053,1,3,4,0.25,0.75,0,0,0,NA,NA
"30","98035",1,0,1,1,0,0,0,0,NA,NA,0,0,0,NA,NA,0,0,0,NA,NA
"31","98036",23,28,51,0.450980392156863,0.549019607843137,9,12,21,0.571428571428571,0.428571428571429,4,4,8,0.5,0.5,2,2,4,0.5,0.5
"32","98037",12,20,32,0.375,0.625,4,6,10,0.6,0.4,2,3,5,0.4,0.6,1,1,2,0.5,0.5
"33","98038",10,30,40,0.25,0.75,2,10,12,0.833333333333333,0.166666666666667,0,2,2,0,1,0,0,0,NA,NA
"34","98039",4,7,11,0.363636363636364,0.636363636363636,3,3,6,0.5,0.5,1,0,1,1,0,0,0,0,NA,NA
"35","98040",24,56,80,0.3,0.7,12,26,38,0.68421052631579,0.315789473684211,5,13,18,0.277777777777778,0.722222222222222,1,1,2,0.5,0.5
"36","98041",0,3,3,0,1,0,2,2,1,0,0,1,1,0,1,0,0,0,NA,NA
"37","98042",19,47,66,0.287878787878788,0.712121212121212,7,22,29,0.758620689655172,0.241379310344828,0,4,4,0,1,0,0,0,NA,NA
"38","98043",7,10,17,0.411764705882353,0.588235294117647,3,3,6,0.5,0.5,2,0,2,1,0,1,1,2,0.5,0.5
"39","98045",18,20,38,0.473684210526316,0.526315789473684,4,5,9,0.555555555555556,0.444444444444444,1,2,3,0.333333333333333,0.666666666666667,1,1,2,0.5,0.5
"40","98046",1,0,1,1,0,0,0,0,NA,NA,0,0,0,NA,NA,0,0,0,NA,NA
"41","98047",1,6,7,0.142857142857143,0.857142857142857,0,1,1,1,0,0,0,0,NA,NA,0,0,0,NA,NA
"42","98050",0,1,1,0,1,0,1,1,1,0,0,0,0,NA,NA,0,0,0,NA,NA
"43","98051",0,11,11,0,1,0,1,1,1,0,0,1,1,0,1,0,0,0,NA,NA
"44","98052",34,54,88,0.386363636363636,0.613636363636364,10,19,29,0.655172413793103,0.344827586206897,1,7,8,0.125,0.875,0,0,0,NA,NA
"45","98053",14,19,33,0.424242424242424,0.575757575757576,5,10,15,0.666666666666667,0.333333333333333,0,4,4,0,1,0,0,0,NA,NA
"46","98055",8,13,21,0.380952380952381,0.619047619047619,3,6,9,0.666666666666667,0.333333333333333,0,1,1,0,1,0,0,0,NA,NA
"47","98056",6,15,21,0.285714285714286,0.714285714285714,3,5,8,0.625,0.375,0,0,0,NA,NA,0,0,0,NA,NA
"48","98057",2,3,5,0.4,0.6,0,1,1,1,0,0,0,0,NA,NA,0,0,0,NA,NA
"49","98058",28,42,70,0.4,0.6,11,16,27,0.592592592592593,0.407407407407407,2,5,7,0.285714285714286,0.714285714285714,0,0,0,NA,NA
"50","98059",19,29,48,0.395833333333333,0.604166666666667,12,15,27,0.555555555555556,0.444444444444444,7,4,11,0.636363636363636,0.363636363636364,3,3,6,0.5,0.5
"51","98063",0,1,1,0,1,0,1,1,1,0,0,0,0,NA,NA,0,0,0,NA,NA
"52","98065",6,6,12,0.5,0.5,1,1,2,0.5,0.5,0,0,0,NA,NA,0,0,0,NA,NA
"53","98068",0,1,1,0,1,0,1,1,1,0,0,0,0,NA,NA,0,0,0,NA,NA
"54","98070",7,15,22,0.318181818181818,0.681818181818182,4,9,13,0.692307692307692,0.307692307692308,0,3,3,0,1,0,0,0,NA,NA
"55","98071",1,0,1,1,0,0,0,0,NA,NA,0,0,0,NA,NA,0,0,0,NA,NA
"56","98072",29,31,60,0.483333333333333,0.516666666666667,13,15,28,0.535714285714286,0.464285714285714,4,4,8,0.5,0.5,1,1,2,0.5,0.5
"57","98073",1,0,1,1,0,0,0,0,NA,NA,0,0,0,NA,NA,0,0,0,NA,NA
"58","98074",30,37,67,0.447761194029851,0.552238805970149,14,10,24,0.416666666666667,0.583333333333333,6,3,9,0.666666666666667,0.333333333333333,1,1,2,0.5,0.5
"59","98075",37,40,77,0.48051948051948,0.519480519480519,20,18,38,0.473684210526316,0.526315789473684,8,6,14,0.571428571428571,0.428571428571429,1,1,2,0.5,0.5
"60","98077",31,37,68,0.455882352941176,0.544117647058823,12,13,25,0.52,0.48,8,2,10,0.8,0.2,2,2,4,0.5,0.5
"61","98082",0,2,2,0,1,0,1,1,1,0,0,0,0,NA,NA,0,0,0,NA,NA
"62","98083",0,1,1,0,1,0,1,1,1,0,0,1,1,0,1,0,0,0,NA,NA
"63","98087",8,17,25,0.32,0.68,3,5,8,0.625,0.375,1,2,3,0.333333333333333,0.666666666666667,0,0,0,NA,NA
"64","98092",17,36,53,0.320754716981132,0.679245283018868,4,12,16,0.75,0.25,2,4,6,0.333333333333333,0.666666666666667,0,0,0,NA,NA
"65","98093",1,1,2,0.5,0.5,1,0,1,0,1,0,0,0,NA,NA,0,0,0,NA,NA
"66","98101",0,1,1,0,1,0,0,0,NA,NA,0,0,0,NA,NA,0,0,0,NA,NA
"67","98102",5,8,13,0.384615384615385,0.615384615384615,4,3,7,0.428571428571429,0.571428571428571,0,0,0,NA,NA,0,0,0,NA,NA
"68","98103",25,27,52,0.480769230769231,0.519230769230769,14,11,25,0.44,0.56,5,3,8,0.625,0.375,1,1,2,0.5,0.5
"69","98104",1,1,2,0.5,0.5,1,1,2,0.5,0.5,0,0,0,NA,NA,0,0,0,NA,NA
"70","98105",15,27,42,0.357142857142857,0.642857142857143,9,12,21,0.571428571428571,0.428571428571429,5,3,8,0.625,0.375,0,0,0,NA,NA
"71","98106",11,22,33,0.333333333333333,0.666666666666667,5,9,14,0.642857142857143,0.357142857142857,3,3,6,0.5,0.5,0,0,0,NA,NA
"72","98107",8,8,16,0.5,0.5,4,2,6,0.333333333333333,0.666666666666667,2,2,4,0.5,0.5,0,0,0,NA,NA
"73","98108",9,18,27,0.333333333333333,0.666666666666667,3,10,13,0.769230769230769,0.230769230769231,0,1,1,0,1,0,0,0,NA,NA
"74","98109",7,7,14,0.5,0.5,3,3,6,0.5,0.5,2,0,2,1,0,2,2,4,0.5,0.5
"75","98110",29,43,72,0.402777777777778,0.597222222222222,8,9,17,0.529411764705882,0.470588235294118,2,5,7,0.285714285714286,0.714285714285714,0,0,0,NA,NA
"76","98111",1,1,2,0.5,0.5,1,0,1,0,1,0,0,0,NA,NA,0,0,0,NA,NA
"77","98112",10,24,34,0.294117647058824,0.705882352941177,5,11,16,0.6875,0.3125,1,4,5,0.2,0.8,0,0,0,NA,NA
"78","98114",0,1,1,0,1,0,0,0,NA,NA,0,0,0,NA,NA,0,0,0,NA,NA
"79","98115",33,53,86,0.383720930232558,0.616279069767442,19,28,47,0.595744680851064,0.404255319148936,4,6,10,0.4,0.6,1,1,2,0.5,0.5
"80","98116",20,24,44,0.454545454545455,0.545454545454545,9,17,26,0.653846153846154,0.346153846153846,1,8,9,0.111111111111111,0.888888888888889,0,0,0,NA,NA
"81","98117",8,40,48,0.166666666666667,0.833333333333333,2,16,18,0.888888888888889,0.111111111111111,0,5,5,0,1,0,0,0,NA,NA
"82","98118",16,27,43,0.372093023255814,0.627906976744186,3,13,16,0.8125,0.1875,1,2,3,0.333333333333333,0.666666666666667,0,0,0,NA,NA
"83","98119",6,15,21,0.285714285714286,0.714285714285714,3,5,8,0.625,0.375,2,0,2,1,0,1,1,2,0.5,0.5
"84","98122",8,5,13,0.615384615384615,0.384615384615385,4,3,7,0.428571428571429,0.571428571428571,0,0,0,NA,NA,0,0,0,NA,NA
"85","98125",16,27,43,0.372093023255814,0.627906976744186,6,18,24,0.75,0.25,1,7,8,0.125,0.875,0,0,0,NA,NA
"86","98126",8,11,19,0.421052631578947,0.578947368421053,3,4,7,0.571428571428571,0.428571428571429,1,0,1,1,0,0,0,0,NA,NA
"87","98133",12,28,40,0.3,0.7,5,17,22,0.772727272727273,0.227272727272727,0,4,4,0,1,0,0,0,NA,NA
"88","98136",4,11,15,0.266666666666667,0.733333333333333,2,8,10,0.8,0.2,0,3,3,0,1,0,0,0,NA,NA
"89","98144",8,18,26,0.307692307692308,0.692307692307692,5,8,13,0.615384615384615,0.384615384615385,2,3,5,0.4,0.6,0,0,0,NA,NA
"90","98146",15,33,48,0.3125,0.6875,5,14,19,0.736842105263158,0.263157894736842,3,3,6,0.5,0.5,0,0,0,NA,NA
"91","98148",6,6,12,0.5,0.5,4,2,6,0.333333333333333,0.666666666666667,1,0,1,1,0,0,0,0,NA,NA
"92","98155",18,23,41,0.439024390243902,0.560975609756098,6,10,16,0.625,0.375,1,4,5,0.2,0.8,0,0,0,NA,NA
"93","98160",0,1,1,0,1,0,1,1,1,0,0,1,1,0,1,0,0,0,NA,NA
"94","98166",9,34,43,0.209302325581395,0.790697674418605,4,21,25,0.84,0.16,1,10,11,0.090909090909091,0.909090909090909,1,1,2,0.5,0.5
"95","98168",9,22,31,0.290322580645161,0.709677419354839,5,7,12,0.583333333333333,0.416666666666667,0,2,2,0,1,0,0,0,NA,NA
"96","98177",22,41,63,0.349206349206349,0.650793650793651,14,20,34,0.588235294117647,0.411764705882353,6,7,13,0.461538461538462,0.538461538461538,2,2,4,0.5,0.5
"97","98178",12,16,28,0.428571428571429,0.571428571428571,3,4,7,0.571428571428571,0.428571428571429,0,0,0,NA,NA,0,0,0,NA,NA
"98","98188",8,9,17,0.470588235294118,0.529411764705882,3,2,5,0.4,0.6,1,0,1,1,0,1,1,2,0.5,0.5
"99","98198",12,32,44,0.272727272727273,0.727272727272727,5,12,17,0.705882352941177,0.294117647058824,2,2,4,0.5,0.5,0,0,0,NA,NA
"100","98199",12,24,36,0.333333333333333,0.666666666666667,7,18,25,0.72,0.28,1,10,11,0.090909090909091,0.909090909090909,1,1,2,0.5,0.5
"101","98201",8,10,18,0.444444444444444,0.555555555555556,6,3,9,0.333333333333333,0.666666666666667,1,1,2,0.5,0.5,1,1,2,0.5,0.5
"102","98203",10,22,32,0.3125,0.6875,5,8,13,0.615384615384615,0.384615384615385,3,2,5,0.6,0.4,0,0,0,NA,NA
"103","98204",6,8,14,0.428571428571429,0.571428571428571,1,3,4,0.75,0.25,0,0,0,NA,NA,0,0,0,NA,NA
"104","98205",3,3,6,0.5,0.5,2,1,3,0.333333333333333,0.666666666666667,0,0,0,NA,NA,0,0,0,NA,NA
"105","98208",25,35,60,0.416666666666667,0.583333333333333,11,11,22,0.5,0.5,6,6,12,0.5,0.5,2,2,4,0.5,0.5
"106","98213",1,1,2,0.5,0.5,1,1,2,0.5,0.5,0,0,0,NA,NA,0,0,0,NA,NA
"107","98220",0,1,1,0,1,0,0,0,NA,NA,0,0,0,NA,NA,0,0,0,NA,NA
"108","98221",7,22,29,0.241379310344828,0.758620689655172,5,11,16,0.6875,0.3125,1,4,5,0.2,0.8,0,0,0,NA,NA
"109","98223",10,19,29,0.344827586206897,0.655172413793103,4,4,8,0.5,0.5,0,1,1,0,1,0,0,0,NA,NA
"110","98225",8,25,33,0.242424242424242,0.757575757575758,2,9,11,0.818181818181818,0.181818181818182,0,4,4,0,1,0,0,0,NA,NA
"111","98226",23,27,50,0.46,0.54,10,12,22,0.545454545454545,0.454545454545455,4,2,6,0.666666666666667,0.333333333333333,0,0,0,NA,NA
"112","98227",0,1,1,0,1,0,0,0,NA,NA,0,0,0,NA,NA,0,0,0,NA,NA
"113","98228",1,0,1,1,0,0,0,0,NA,NA,0,0,0,NA,NA,0,0,0,NA,NA
"114","98229",15,18,33,0.454545454545455,0.545454545454545,9,10,19,0.526315789473684,0.473684210526316,3,3,6,0.5,0.5,1,1,2,0.5,0.5
"115","98230",3,7,10,0.3,0.7,2,2,4,0.5,0.5,0,0,0,NA,NA,0,0,0,NA,NA
"116","98231",0,1,1,0,1,0,1,1,1,0,0,0,0,NA,NA,0,0,0,NA,NA
"117","98232",3,5,8,0.375,0.625,2,2,4,0.5,0.5,1,0,1,1,0,0,0,0,NA,NA
"118","98233",6,13,19,0.315789473684211,0.68421052631579,3,5,8,0.625,0.375,2,2,4,0.5,0.5,0,0,0,NA,NA
"119","98236",3,1,4,0.75,0.25,1,0,1,0,1,0,0,0,NA,NA,0,0,0,NA,NA
"120","98237",3,3,6,0.5,0.5,1,0,1,0,1,0,0,0,NA,NA,0,0,0,NA,NA
"121","98239",1,5,6,0.166666666666667,0.833333333333333,1,0,1,0,1,1,0,1,1,0,0,0,0,NA,NA
"122","98240",0,2,2,0,1,0,1,1,1,0,0,0,0,NA,NA,0,0,0,NA,NA
"123","98244",0,5,5,0,1,0,3,3,1,0,0,1,1,0,1,0,0,0,NA,NA
"124","98245",0,3,3,0,1,0,2,2,1,0,0,1,1,0,1,0,0,0,NA,NA
"125","98247",4,9,13,0.307692307692308,0.692307692307692,1,4,5,0.8,0.2,0,1,1,0,1,0,0,0,NA,NA
"126","98248",4,19,23,0.173913043478261,0.826086956521739,1,3,4,0.75,0.25,1,0,1,1,0,0,0,0,NA,NA
"127","98249",1,3,4,0.25,0.75,1,0,1,0,1,1,0,1,1,0,0,0,0,NA,NA
"128","98250",6,6,12,0.5,0.5,1,3,4,0.75,0.25,1,1,2,0.5,0.5,0,0,0,NA,NA
"129","98251",3,7,10,0.3,0.7,0,0,0,NA,NA,0,0,0,NA,NA,0,0,0,NA,NA
"130","98252",4,4,8,0.5,0.5,1,1,2,0.5,0.5,0,0,0,NA,NA,0,0,0,NA,NA
"131","98253",2,0,2,1,0,1,0,1,0,1,1,0,1,1,0,0,0,0,NA,NA
"132","98257",2,0,2,1,0,1,0,1,0,1,0,0,0,NA,NA,0,0,0,NA,NA
"133","98258",9,19,28,0.321428571428571,0.678571428571429,4,5,9,0.555555555555556,0.444444444444444,0,2,2,0,1,0,0,0,NA,NA
"134","98260",3,1,4,0.75,0.25,2,1,3,0.333333333333333,0.666666666666667,0,0,0,NA,NA,0,0,0,NA,NA
"135","98261",2,2,4,0.5,0.5,1,0,1,0,1,0,0,0,NA,NA,0,0,0,NA,NA
"136","98262",1,0,1,1,0,0,0,0,NA,NA,0,0,0,NA,NA,0,0,0,NA,NA
"137","98264",13,16,29,0.448275862068966,0.551724137931034,4,7,11,0.636363636363636,0.363636363636364,0,1,1,0,1,0,0,0,NA,NA
"138","98266",1,0,1,1,0,0,0,0,NA,NA,0,0,0,NA,NA,0,0,0,NA,NA
"139","98267",0,1,1,0,1,0,0,0,NA,NA,0,0,0,NA,NA,0,0,0,NA,NA
"140","98270",15,19,34,0.441176470588235,0.558823529411765,0,7,7,1,0,0,1,1,0,1,0,0,0,NA,NA
"141","98271",13,10,23,0.565217391304348,0.434782608695652,5,3,8,0.375,0.625,2,1,3,0.666666666666667,0.333333333333333,1,1,2,0.5,0.5
"142","98272",7,14,21,0.333333333333333,0.666666666666667,1,4,5,0.8,0.2,1,0,1,1,0,1,1,2,0.5,0.5
"143","98273",11,16,27,0.407407407407407,0.592592592592593,4,3,7,0.428571428571429,0.571428571428571,2,2,4,0.5,0.5,2,2,4,0.5,0.5
"144","98274",9,13,22,0.409090909090909,0.590909090909091,3,3,6,0.5,0.5,1,1,2,0.5,0.5,0,0,0,NA,NA
"145","98275",16,25,41,0.390243902439024,0.609756097560976,3,8,11,0.727272727272727,0.272727272727273,0,7,7,0,1,0,0,0,NA,NA
"146","98277",17,26,43,0.395348837209302,0.604651162790698,4,1,5,0.2,0.8,2,0,2,1,0,0,0,0,NA,NA
"147","98280",0,3,3,0,1,0,1,1,1,0,0,0,0,NA,NA,0,0,0,NA,NA
"148","98281",0,1,1,0,1,0,0,0,NA,NA,0,0,0,NA,NA,0,0,0,NA,NA
"149","98282",8,5,13,0.615384615384615,0.384615384615385,3,1,4,0.25,0.75,1,1,2,0.5,0.5,0,0,0,NA,NA
"150","98284",4,17,21,0.190476190476190,0.80952380952381,1,4,5,0.8,0.2,0,0,0,NA,NA,0,0,0,NA,NA
"151","98286",0,1,1,0,1,0,0,0,NA,NA,0,0,0,NA,NA,0,0,0,NA,NA
"152","98287",0,3,3,0,1,0,2,2,1,0,0,0,0,NA,NA,0,0,0,NA,NA
"153","98290",19,26,45,0.422222222222222,0.577777777777778,6,10,16,0.625,0.375,5,3,8,0.625,0.375,1,1,2,0.5,0.5
"154","98292",8,23,31,0.258064516129032,0.741935483870968,2,7,9,0.777777777777778,0.222222222222222,0,6,6,0,1,0,0,0,NA,NA
"155","98293",0,1,1,0,1,0,0,0,NA,NA,0,0,0,NA,NA,0,0,0,NA,NA
"156","98294",2,4,6,0.333333333333333,0.666666666666667,0,1,1,1,0,0,0,0,NA,NA,0,0,0,NA,NA
"157","98295",1,0,1,1,0,0,0,0,NA,NA,0,0,0,NA,NA,0,0,0,NA,NA
"158","98296",17,26,43,0.395348837209302,0.604651162790698,9,15,24,0.625,0.375,5,7,12,0.416666666666667,0.583333333333333,1,1,2,0.5,0.5
"159","98303",0,3,3,0,1,0,1,1,1,0,0,0,0,NA,NA,0,0,0,NA,NA
"160","98305",0,1,1,0,1,0,0,0,NA,NA,0,0,0,NA,NA,0,0,0,NA,NA
"161","98310",13,8,21,0.619047619047619,0.380952380952381,6,2,8,0.25,0.75,1,0,1,1,0,1,1,2,0.5,0.5
"162","98311",14,26,40,0.35,0.65,2,8,10,0.8,0.2,0,2,2,0,1,0,0,0,NA,NA
"163","98312",6,19,25,0.24,0.76,2,6,8,0.75,0.25,0,2,2,0,1,0,0,0,NA,NA
"164","98315",0,1,1,0,1,0,0,0,NA,NA,0,0,0,NA,NA,0,0,0,NA,NA
"165","98321",6,13,19,0.315789473684211,0.68421052631579,1,2,3,0.666666666666667,0.333333333333333,0,2,2,0,1,0,0,0,NA,NA
"166","98323",0,2,2,0,1,0,1,1,1,0,0,0,0,NA,NA,0,0,0,NA,NA
"167","98324",0,1,1,0,1,0,1,1,1,0,0,0,0,NA,NA,0,0,0,NA,NA
"168","98325",2,1,3,0.666666666666667,0.333333333333333,0,0,0,NA,NA,0,0,0,NA,NA,0,0,0,NA,NA
"169","98326",1,2,3,0.333333333333333,0.666666666666667,0,0,0,NA,NA,0,0,0,NA,NA,0,0,0,NA,NA
"170","98327",3,8,11,0.272727272727273,0.727272727272727,0,4,4,1,0,0,3,3,0,1,0,0,0,NA,NA
"171","98328",2,6,8,0.25,0.75,1,3,4,0.75,0.25,1,2,3,0.333333333333333,0.666666666666667,0,0,0,NA,NA
"172","98329",1,4,5,0.2,0.8,0,1,1,1,0,0,1,1,0,1,0,0,0,NA,NA
"173","98331",4,7,11,0.363636363636364,0.636363636363636,0,2,2,1,0,0,0,0,NA,NA,0,0,0,NA,NA
"174","98332",16,18,34,0.470588235294118,0.529411764705882,8,5,13,0.384615384615385,0.615384615384615,3,2,5,0.6,0.4,2,2,4,0.5,0.5
"175","98333",4,6,10,0.4,0.6,2,3,5,0.6,0.4,1,0,1,1,0,0,0,0,NA,NA
"176","98335",30,48,78,0.384615384615385,0.615384615384615,13,23,36,0.638888888888889,0.361111111111111,4,3,7,0.571428571428571,0.428571428571429,0,0,0,NA,NA
"177","98336",1,0,1,1,0,0,0,0,NA,NA,0,0,0,NA,NA,0,0,0,NA,NA
"178","98337",2,4,6,0.333333333333333,0.666666666666667,1,3,4,0.75,0.25,0,0,0,NA,NA,0,0,0,NA,NA
"179","98338",17,19,36,0.472222222222222,0.527777777777778,6,9,15,0.6,0.4,1,3,4,0.25,0.75,0,0,0,NA,NA
"180","98339",0,4,4,0,1,0,1,1,1,0,0,1,1,0,1,0,0,0,NA,NA
"181","98340",0,1,1,0,1,0,0,0,NA,NA,0,0,0,NA,NA,0,0,0,NA,NA
"182","98344",0,1,1,0,1,0,0,0,NA,NA,0,0,0,NA,NA,0,0,0,NA,NA
"183","98345",3,1,4,0.75,0.25,0,0,0,NA,NA,0,0,0,NA,NA,0,0,0,NA,NA
"184","98346",4,7,11,0.363636363636364,0.636363636363636,2,3,5,0.6,0.4,0,1,1,0,1,0,0,0,NA,NA
"185","98349",1,2,3,0.333333333333333,0.666666666666667,0,0,0,NA,NA,0,0,0,NA,NA,0,0,0,NA,NA
"186","98350",0,0,0,NA,NA,0,0,0,NA,NA,0,0,0,NA,NA,0,0,0,NA,NA
"187","98354",1,7,8,0.125,0.875,0,2,2,1,0,0,1,1,0,1,0,0,0,NA,NA
"188","98356",1,1,2,0.5,0.5,0,0,0,NA,NA,0,0,0,NA,NA,0,0,0,NA,NA
"189","98357",2,2,4,0.5,0.5,2,0,2,0,1,1,0,1,1,0,0,0,0,NA,NA
"190","98359",3,7,10,0.3,0.7,1,1,2,0.5,0.5,0,1,1,0,1,0,0,0,NA,NA
"191","98360",5,9,14,0.357142857142857,0.642857142857143,1,3,4,0.75,0.25,0,0,0,NA,NA,0,0,0,NA,NA
"192","98361",0,1,1,0,1,0,0,0,NA,NA,0,0,0,NA,NA,0,0,0,NA,NA
"193","98362",9,14,23,0.391304347826087,0.608695652173913,5,6,11,0.545454545454545,0.454545454545455,3,1,4,0.75,0.25,1,1,2,0.5,0.5
"194","98363",3,1,4,0.75,0.25,3,1,4,0.25,0.75,1,0,1,1,0,1,1,2,0.5,0.5
"195","98364",0,1,1,0,1,0,1,1,1,0,0,0,0,NA,NA,0,0,0,NA,NA
"196","98365",0,3,3,0,1,0,1,1,1,0,0,1,1,0,1,0,0,0,NA,NA
"197","98366",11,30,41,0.268292682926829,0.73170731707317,2,3,5,0.6,0.4,0,0,0,NA,NA,0,0,0,NA,NA
"198","98367",15,20,35,0.428571428571429,0.571428571428571,5,3,8,0.375,0.625,2,2,4,0.5,0.5,0,0,0,NA,NA
"199","98368",4,12,16,0.25,0.75,0,4,4,1,0,0,2,2,0,1,0,0,0,NA,NA
"200","98370",21,35,56,0.375,0.625,5,18,23,0.782608695652174,0.217391304347826,2,4,6,0.333333333333333,0.666666666666667,0,0,0,NA,NA
"201","98371",11,15,26,0.423076923076923,0.576923076923077,6,7,13,0.538461538461538,0.461538461538462,2,2,4,0.5,0.5,1,1,2,0.5,0.5
"202","98372",6,16,22,0.272727272727273,0.727272727272727,2,8,10,0.8,0.2,0,2,2,0,1,0,0,0,NA,NA
"203","98373",13,14,27,0.481481481481481,0.518518518518518,4,3,7,0.428571428571429,0.571428571428571,1,1,2,0.5,0.5,0,0,0,NA,NA
"204","98374",17,33,50,0.34,0.66,5,11,16,0.6875,0.3125,0,1,1,0,1,0,0,0,NA,NA
"205","98375",17,17,34,0.5,0.5,2,5,7,0.714285714285714,0.285714285714286,1,0,1,1,0,0,0,0,NA,NA
"206","98376",0,1,1,0,1,0,0,0,NA,NA,0,0,0,NA,NA,0,0,0,NA,NA
"207","98377",2,2,4,0.5,0.5,0,0,0,NA,NA,0,0,0,NA,NA,0,0,0,NA,NA
"208","98380",1,2,3,0.333333333333333,0.666666666666667,0,1,1,1,0,0,1,1,0,1,0,0,0,NA,NA
"209","98381",0,3,3,0,1,0,0,0,NA,NA,0,0,0,NA,NA,0,0,0,NA,NA
"210","98382",12,11,23,0.521739130434783,0.478260869565217,4,4,8,0.5,0.5,2,2,4,0.5,0.5,0,0,0,NA,NA
"211","98383",9,24,33,0.272727272727273,0.727272727272727,5,5,10,0.5,0.5,1,2,3,0.333333333333333,0.666666666666667,0,0,0,NA,NA
"212","98384",3,1,4,0.75,0.25,0,0,0,NA,NA,0,0,0,NA,NA,0,0,0,NA,NA
"213","98386",0,1,1,0,1,0,0,0,NA,NA,0,0,0,NA,NA,0,0,0,NA,NA
"214","98387",10,25,35,0.285714285714286,0.714285714285714,4,5,9,0.555555555555556,0.444444444444444,2,0,2,1,0,0,0,0,NA,NA
"215","98388",3,1,4,0.75,0.25,2,1,3,0.333333333333333,0.666666666666667,1,0,1,1,0,1,1,2,0.5,0.5
"216","98390",5,8,13,0.384615384615385,0.615384615384615,0,1,1,1,0,0,0,0,NA,NA,0,0,0,NA,NA
"217","98391",27,41,68,0.397058823529412,0.602941176470588,10,19,29,0.655172413793103,0.344827586206897,3,6,9,0.333333333333333,0.666666666666667,1,1,2,0.5,0.5
"218","98392",1,3,4,0.25,0.75,1,1,2,0.5,0.5,1,0,1,1,0,0,0,0,NA,NA
"219","98394",0,2,2,0,1,0,0,0,NA,NA,0,0,0,NA,NA,0,0,0,NA,NA
"220","98403",3,6,9,0.333333333333333,0.666666666666667,2,4,6,0.666666666666667,0.333333333333333,2,2,4,0.5,0.5,0,0,0,NA,NA
"221","98404",8,19,27,0.296296296296296,0.703703703703704,2,5,7,0.714285714285714,0.285714285714286,0,0,0,NA,NA,0,0,0,NA,NA
"222","98405",6,10,16,0.375,0.625,4,3,7,0.428571428571429,0.571428571428571,0,0,0,NA,NA,0,0,0,NA,NA
"223","98406",20,19,39,0.512820512820513,0.487179487179487,12,10,22,0.454545454545455,0.545454545454545,6,7,13,0.461538461538462,0.538461538461538,0,0,0,NA,NA
"224","98407",12,18,30,0.4,0.6,9,7,16,0.4375,0.5625,2,2,4,0.5,0.5,2,2,4,0.5,0.5
"225","98408",7,17,24,0.291666666666667,0.708333333333333,2,6,8,0.75,0.25,0,0,0,NA,NA,0,0,0,NA,NA
"226","98409",5,14,19,0.263157894736842,0.736842105263158,1,5,6,0.833333333333333,0.166666666666667,1,0,1,1,0,0,0,0,NA,NA
"227","98411",0,2,2,0,1,0,1,1,1,0,0,1,1,0,1,0,0,0,NA,NA
"228","98418",3,4,7,0.428571428571429,0.571428571428571,3,0,3,0,1,0,0,0,NA,NA,0,0,0,NA,NA
"229","98422",19,19,38,0.5,0.5,10,8,18,0.444444444444444,0.555555555555556,4,2,6,0.666666666666667,0.333333333333333,1,1,2,0.5,0.5
"230","98424",2,7,9,0.222222222222222,0.777777777777778,0,2,2,1,0,0,0,0,NA,NA,0,0,0,NA,NA
"231","98433",3,2,5,0.6,0.4,1,0,1,0,1,1,0,1,1,0,0,0,0,NA,NA
"232","98439",2,3,5,0.4,0.6,1,1,2,0.5,0.5,0,0,0,NA,NA,0,0,0,NA,NA
"233","98443",5,5,10,0.5,0.5,3,2,5,0.4,0.6,1,0,1,1,0,1,1,2,0.5,0.5
"234","98444",4,16,20,0.2,0.8,1,4,5,0.8,0.2,1,0,1,1,0,0,0,0,NA,NA
"235","98445",10,17,27,0.370370370370370,0.62962962962963,3,7,10,0.7,0.3,0,0,0,NA,NA,0,0,0,NA,NA
"236","98446",2,6,8,0.25,0.75,1,0,1,0,1,1,0,1,1,0,0,0,0,NA,NA
"237","98448",1,0,1,1,0,1,0,1,0,1,0,0,0,NA,NA,0,0,0,NA,NA
"238","98464",0,2,2,0,1,0,2,2,1,0,0,0,0,NA,NA,0,0,0,NA,NA
"239","98465",6,6,12,0.5,0.5,1,5,6,0.833333333333333,0.166666666666667,1,5,6,0.166666666666667,0.833333333333333,0,0,0,NA,NA
"240","98466",16,25,41,0.390243902439024,0.609756097560976,9,10,19,0.526315789473684,0.473684210526316,3,6,9,0.333333333333333,0.666666666666667,1,1,2,0.5,0.5
"241","98467",15,11,26,0.576923076923077,0.423076923076923,9,2,11,0.181818181818182,0.818181818181818,1,0,1,1,0,0,0,0,NA,NA
"242","98496",2,0,2,1,0,1,0,1,0,1,0,0,0,NA,NA,0,0,0,NA,NA
"243","98497",0,1,1,0,1,0,0,0,NA,NA,0,0,0,NA,NA,0,0,0,NA,NA
"244","98498",20,28,48,0.416666666666667,0.583333333333333,12,14,26,0.538461538461538,0.461538461538462,2,2,4,0.5,0.5,0,0,0,NA,NA
"245","98499",19,12,31,0.612903225806452,0.387096774193548,6,6,12,0.5,0.5,1,1,2,0.5,0.5,0,0,0,NA,NA
"246","98501",28,50,78,0.358974358974359,0.641025641025641,10,23,33,0.696969696969697,0.303030303030303,4,8,12,0.333333333333333,0.666666666666667,2,2,4,0.5,0.5
"247","98502",23,27,50,0.46,0.54,9,13,22,0.590909090909091,0.409090909090909,4,4,8,0.5,0.5,0,0,0,NA,NA
"248","98503",13,38,51,0.254901960784314,0.745098039215686,5,13,18,0.722222222222222,0.277777777777778,1,2,3,0.333333333333333,0.666666666666667,0,0,0,NA,NA
"249","98506",5,14,19,0.263157894736842,0.736842105263158,3,2,5,0.4,0.6,1,0,1,1,0,1,1,2,0.5,0.5
"250","98507",2,1,3,0.666666666666667,0.333333333333333,2,0,2,0,1,1,0,1,1,0,0,0,0,NA,NA
"251","98508",0,1,1,0,1,0,0,0,NA,NA,0,0,0,NA,NA,0,0,0,NA,NA
"252","98509",1,0,1,1,0,1,0,1,0,1,0,0,0,NA,NA,0,0,0,NA,NA
"253","98512",18,23,41,0.439024390243902,0.560975609756098,10,12,22,0.545454545454545,0.454545454545455,2,6,8,0.25,0.75,0,0,0,NA,NA
"254","98513",15,28,43,0.348837209302326,0.651162790697674,7,10,17,0.588235294117647,0.411764705882353,2,2,4,0.5,0.5,0,0,0,NA,NA
"255","98516",10,14,24,0.416666666666667,0.583333333333333,7,6,13,0.461538461538462,0.538461538461538,1,2,3,0.333333333333333,0.666666666666667,0,0,0,NA,NA
"256","98520",4,25,29,0.137931034482759,0.862068965517241,1,11,12,0.916666666666667,0.0833333333333333,1,4,5,0.2,0.8,1,1,2,0.5,0.5
"257","98524",0,2,2,0,1,0,2,2,1,0,0,0,0,NA,NA,0,0,0,NA,NA
"258","98527",0,1,1,0,1,0,0,0,NA,NA,0,0,0,NA,NA,0,0,0,NA,NA
"259","98528",1,2,3,0.333333333333333,0.666666666666667,0,0,0,NA,NA,0,0,0,NA,NA,0,0,0,NA,NA
"260","98531",7,13,20,0.35,0.65,0,2,2,1,0,0,1,1,0,1,0,0,0,NA,NA
"261","98532",9,16,25,0.36,0.64,2,4,6,0.666666666666667,0.333333333333333,0,0,0,NA,NA,0,0,0,NA,NA
"262","98539",0,1,1,0,1,0,0,0,NA,NA,0,0,0,NA,NA,0,0,0,NA,NA
"263","98540",0,1,1,0,1,0,1,1,1,0,0,1,1,0,1,0,0,0,NA,NA
"264","98541",1,3,4,0.25,0.75,0,0,0,NA,NA,0,0,0,NA,NA,0,0,0,NA,NA
"265","98546",1,1,2,0.5,0.5,0,0,0,NA,NA,0,0,0,NA,NA,0,0,0,NA,NA
"266","98550",8,14,22,0.363636363636364,0.636363636363636,2,3,5,0.6,0.4,1,1,2,0.5,0.5,0,0,0,NA,NA
"267","98556",0,1,1,0,1,0,0,0,NA,NA,0,0,0,NA,NA,0,0,0,NA,NA
"268","98557",0,1,1,0,1,0,0,0,NA,NA,0,0,0,NA,NA,0,0,0,NA,NA
"269","98558",1,1,2,0.5,0.5,0,1,1,1,0,0,0,0,NA,NA,0,0,0,NA,NA
"270","98561",0,1,1,0,1,0,1,1,1,0,0,1,1,0,1,0,0,0,NA,NA
"271","98563",2,6,8,0.25,0.75,0,1,1,1,0,0,0,0,NA,NA,0,0,0,NA,NA
"272","98564",2,1,3,0.666666666666667,0.333333333333333,1,0,1,0,1,0,0,0,NA,NA,0,0,0,NA,NA
"273","98565",1,0,1,1,0,0,0,0,NA,NA,0,0,0,NA,NA,0,0,0,NA,NA
"274","98570",2,2,4,0.5,0.5,1,0,1,0,1,0,0,0,NA,NA,0,0,0,NA,NA
"275","98575",0,0,0,NA,NA,0,0,0,NA,NA,0,0,0,NA,NA,0,0,0,NA,NA
"276","98576",1,2,3,0.333333333333333,0.666666666666667,0,0,0,NA,NA,0,0,0,NA,NA,0,0,0,NA,NA
"277","98577",5,7,12,0.416666666666667,0.583333333333333,1,5,6,0.833333333333333,0.166666666666667,1,1,2,0.5,0.5,0,0,0,NA,NA
"278","98579",2,6,8,0.25,0.75,0,1,1,1,0,0,1,1,0,1,0,0,0,NA,NA
"279","98580",1,5,6,0.166666666666667,0.833333333333333,1,0,1,0,1,0,0,0,NA,NA,0,0,0,NA,NA
"280","98583",1,0,1,1,0,0,0,0,NA,NA,0,0,0,NA,NA,0,0,0,NA,NA
"281","98584",1,17,18,0.0555555555555556,0.944444444444444,0,8,8,1,0,0,2,2,0,1,0,0,0,NA,NA
"282","98585",0,1,1,0,1,0,0,0,NA,NA,0,0,0,NA,NA,0,0,0,NA,NA
"283","98586",0,1,1,0,1,0,0,0,NA,NA,0,0,0,NA,NA,0,0,0,NA,NA
"284","98587",0,1,1,0,1,0,1,1,1,0,0,0,0,NA,NA,0,0,0,NA,NA
"285","98588",1,2,3,0.333333333333333,0.666666666666667,0,0,0,NA,NA,0,0,0,NA,NA,0,0,0,NA,NA
"286","98589",0,12,12,0,1,0,3,3,1,0,0,1,1,0,1,0,0,0,NA,NA
"287","98591",3,0,3,1,0,2,0,2,0,1,1,0,1,1,0,0,0,0,NA,NA
"288","98593",2,0,2,1,0,0,0,0,NA,NA,0,0,0,NA,NA,0,0,0,NA,NA
"289","98595",0,2,2,0,1,0,1,1,1,0,0,0,0,NA,NA,0,0,0,NA,NA
"290","98596",2,3,5,0.4,0.6,1,1,2,0.5,0.5,0,0,0,NA,NA,0,0,0,NA,NA
"291","98597",2,19,21,0.0952380952380952,0.904761904761905,1,10,11,0.909090909090909,0.090909090909091,0,5,5,0,1,0,0,0,NA,NA
"292","98601",4,3,7,0.571428571428571,0.428571428571429,4,2,6,0.333333333333333,0.666666666666667,0,0,0,NA,NA,0,0,0,NA,NA
"293","98603",0,1,1,0,1,0,0,0,NA,NA,0,0,0,NA,NA,0,0,0,NA,NA
"294","98604",18,35,53,0.339622641509434,0.660377358490566,7,20,27,0.740740740740741,0.259259259259259,4,2,6,0.666666666666667,0.333333333333333,4,4,8,0.5,0.5
"295","98606",7,17,24,0.291666666666667,0.708333333333333,2,10,12,0.833333333333333,0.166666666666667,1,2,3,0.333333333333333,0.666666666666667,1,1,2,0.5,0.5
"296","98607",33,34,67,0.492537313432836,0.507462686567164,15,18,33,0.545454545454545,0.454545454545455,7,6,13,0.538461538461538,0.461538461538462,2,2,4,0.5,0.5
"297","98610",1,1,2,0.5,0.5,0,1,1,1,0,0,1,1,0,1,0,0,0,NA,NA
"298","98611",5,9,14,0.357142857142857,0.642857142857143,1,2,3,0.666666666666667,0.333333333333333,0,0,0,NA,NA,0,0,0,NA,NA
"299","98612",2,2,4,0.5,0.5,2,2,4,0.5,0.5,0,0,0,NA,NA,0,0,0,NA,NA
"300","98617",0,1,1,0,1,0,0,0,NA,NA,0,0,0,NA,NA,0,0,0,NA,NA
"301","98620",1,3,4,0.25,0.75,0,0,0,NA,NA,0,0,0,NA,NA,0,0,0,NA,NA
"302","98623",1,0,1,1,0,0,0,0,NA,NA,0,0,0,NA,NA,0,0,0,NA,NA
"303","98624",1,0,1,1,0,1,0,1,0,1,0,0,0,NA,NA,0,0,0,NA,NA
"304","98625",1,8,9,0.111111111111111,0.888888888888889,1,4,5,0.8,0.2,0,1,1,0,1,0,0,0,NA,NA
"305","98626",11,32,43,0.255813953488372,0.744186046511628,3,11,14,0.785714285714286,0.214285714285714,0,2,2,0,1,0,0,0,NA,NA
"306","98628",0,1,1,0,1,0,0,0,NA,NA,0,0,0,NA,NA,0,0,0,NA,NA
"307","98629",4,5,9,0.444444444444444,0.555555555555556,2,3,5,0.6,0.4,2,2,4,0.5,0.5,1,1,2,0.5,0.5
"308","98631",2,0,2,1,0,0,0,0,NA,NA,0,0,0,NA,NA,0,0,0,NA,NA
"309","98632",23,46,69,0.333333333333333,0.666666666666667,11,11,22,0.5,0.5,2,1,3,0.666666666666667,0.333333333333333,0,0,0,NA,NA
"310","98638",0,2,2,0,1,0,1,1,1,0,0,0,0,NA,NA,0,0,0,NA,NA
"311","98639",2,0,2,1,0,1,0,1,0,1,0,0,0,NA,NA,0,0,0,NA,NA
"312","98640",1,0,1,1,0,0,0,0,NA,NA,0,0,0,NA,NA,0,0,0,NA,NA
"313","98641",0,1,1,0,1,0,0,0,NA,NA,0,0,0,NA,NA,0,0,0,NA,NA
"314","98642",6,16,22,0.272727272727273,0.727272727272727,1,7,8,0.875,0.125,0,1,1,0,1,0,0,0,NA,NA
"315","98645",1,1,2,0.5,0.5,0,0,0,NA,NA,0,0,0,NA,NA,0,0,0,NA,NA
"316","98647",0,1,1,0,1,0,0,0,NA,NA,0,0,0,NA,NA,0,0,0,NA,NA
"317","98648",2,1,3,0.666666666666667,0.333333333333333,2,0,2,0,1,1,0,1,1,0,1,1,2,0.5,0.5
"318","98650",1,2,3,0.333333333333333,0.666666666666667,0,0,0,NA,NA,0,0,0,NA,NA,0,0,0,NA,NA
"319","98651",1,0,1,1,0,1,0,1,0,1,0,0,0,NA,NA,0,0,0,NA,NA
"320","98660",5,6,11,0.454545454545455,0.545454545454545,1,2,3,0.666666666666667,0.333333333333333,0,0,0,NA,NA,0,0,0,NA,NA
"321","98661",15,31,46,0.326086956521739,0.673913043478261,8,10,18,0.555555555555556,0.444444444444444,4,3,7,0.571428571428571,0.428571428571429,3,3,6,0.5,0.5
"322","98662",11,18,29,0.379310344827586,0.620689655172414,2,7,9,0.777777777777778,0.222222222222222,0,3,3,0,1,0,0,0,NA,NA
"323","98663",4,8,12,0.333333333333333,0.666666666666667,2,3,5,0.6,0.4,1,2,3,0.333333333333333,0.666666666666667,0,0,0,NA,NA
"324","98664",11,16,27,0.407407407407407,0.592592592592593,6,6,12,0.5,0.5,2,2,4,0.5,0.5,1,1,2,0.5,0.5
"325","98665",12,16,28,0.428571428571429,0.571428571428571,7,10,17,0.588235294117647,0.411764705882353,3,2,5,0.6,0.4,1,1,2,0.5,0.5
"326","98666",1,0,1,1,0,0,0,0,NA,NA,0,0,0,NA,NA,0,0,0,NA,NA
"327","98671",5,22,27,0.185185185185185,0.814814814814815,1,14,15,0.933333333333333,0.0666666666666667,1,4,5,0.2,0.8,0,0,0,NA,NA
"328","98672",4,4,8,0.5,0.5,2,1,3,0.333333333333333,0.666666666666667,1,0,1,1,0,1,1,2,0.5,0.5
"329","98674",9,14,23,0.391304347826087,0.608695652173913,1,7,8,0.875,0.125,0,1,1,0,1,0,0,0,NA,NA
"330","98675",3,3,6,0.5,0.5,3,2,5,0.4,0.6,1,1,2,0.5,0.5,1,1,2,0.5,0.5
"331","98682",31,55,86,0.36046511627907,0.63953488372093,11,25,36,0.694444444444444,0.305555555555556,2,4,6,0.333333333333333,0.666666666666667,1,1,2,0.5,0.5
"332","98683",17,22,39,0.435897435897436,0.564102564102564,5,12,17,0.705882352941177,0.294117647058824,1,5,6,0.166666666666667,0.833333333333333,1,1,2,0.5,0.5
"333","98684",11,23,34,0.323529411764706,0.676470588235294,3,8,11,0.727272727272727,0.272727272727273,0,2,2,0,1,0,0,0,NA,NA
"334","98685",19,37,56,0.339285714285714,0.660714285714286,8,14,22,0.636363636363636,0.363636363636364,3,7,10,0.3,0.7,1,1,2,0.5,0.5
"335","98686",14,25,39,0.358974358974359,0.641025641025641,8,11,19,0.578947368421053,0.421052631578947,2,7,9,0.222222222222222,0.777777777777778,0,0,0,NA,NA
"336","98687",0,2,2,0,1,0,2,2,1,0,0,2,2,0,1,0,0,0,NA,NA
"337","98801",8,15,23,0.347826086956522,0.652173913043478,1,8,9,0.888888888888889,0.111111111111111,1,5,6,0.166666666666667,0.833333333333333,0,0,0,NA,NA
"338","98802",7,5,12,0.583333333333333,0.416666666666667,3,1,4,0.25,0.75,0,1,1,0,1,0,0,0,NA,NA
"339","98807",3,1,4,0.75,0.25,1,0,1,0,1,1,0,1,1,0,0,0,0,NA,NA
"340","98812",3,3,6,0.5,0.5,0,1,1,1,0,0,0,0,NA,NA,0,0,0,NA,NA
"341","98813",1,5,6,0.166666666666667,0.833333333333333,0,1,1,1,0,0,0,0,NA,NA,0,0,0,NA,NA
"342","98815",1,0,1,1,0,1,0,1,0,1,1,0,1,1,0,0,0,0,NA,NA
"343","98816",6,3,9,0.666666666666667,0.333333333333333,2,1,3,0.333333333333333,0.666666666666667,0,1,1,0,1,0,0,0,NA,NA
"344","98822",0,1,1,0,1,0,0,0,NA,NA,0,0,0,NA,NA,0,0,0,NA,NA
"345","98823",0,2,2,0,1,0,1,1,1,0,0,1,1,0,1,0,0,0,NA,NA
"346","98826",3,1,4,0.75,0.25,0,0,0,NA,NA,0,0,0,NA,NA,0,0,0,NA,NA
"347","98828",1,0,1,1,0,0,0,0,NA,NA,0,0,0,NA,NA,0,0,0,NA,NA
"348","98831",2,1,3,0.666666666666667,0.333333333333333,0,0,0,NA,NA,0,0,0,NA,NA,0,0,0,NA,NA
"349","98837",4,14,18,0.222222222222222,0.777777777777778,3,6,9,0.666666666666667,0.333333333333333,1,1,2,0.5,0.5,0,0,0,NA,NA
"350","98840",1,3,4,0.25,0.75,1,1,2,0.5,0.5,0,0,0,NA,NA,0,0,0,NA,NA
"351","98841",2,0,2,1,0,2,0,2,0,1,1,0,1,1,0,0,0,0,NA,NA
"352","98846",0,3,3,0,1,0,1,1,1,0,0,0,0,NA,NA,0,0,0,NA,NA
"353","98848",2,6,8,0.25,0.75,0,1,1,1,0,0,1,1,0,1,0,0,0,NA,NA
"354","98855",0,1,1,0,1,0,0,0,NA,NA,0,0,0,NA,NA,0,0,0,NA,NA
"355","98856",0,1,1,0,1,0,0,0,NA,NA,0,0,0,NA,NA,0,0,0,NA,NA
"356","98857",0,2,2,0,1,0,0,0,NA,NA,0,0,0,NA,NA,0,0,0,NA,NA
"357","98862",0,1,1,0,1,0,0,0,NA,NA,0,0,0,NA,NA,0,0,0,NA,NA
"358","98901",5,8,13,0.384615384615385,0.615384615384615,1,2,3,0.666666666666667,0.333333333333333,0,0,0,NA,NA,0,0,0,NA,NA
"359","98902",11,19,30,0.366666666666667,0.633333333333333,4,4,8,0.5,0.5,4,0,4,1,0,0,0,0,NA,NA
"360","98903",0,6,6,0,1,0,1,1,1,0,0,1,1,0,1,0,0,0,NA,NA
"361","98907",0,1,1,0,1,0,1,1,1,0,0,0,0,NA,NA,0,0,0,NA,NA
"362","98908",14,38,52,0.269230769230769,0.730769230769231,6,19,25,0.76,0.24,1,8,9,0.111111111111111,0.888888888888889,0,0,0,NA,NA
"363","98922",0,1,1,0,1,0,0,0,NA,NA,0,0,0,NA,NA,0,0,0,NA,NA
"364","98923",1,0,1,1,0,0,0,0,NA,NA,0,0,0,NA,NA,0,0,0,NA,NA
"365","98926",8,13,21,0.380952380952381,0.619047619047619,0,4,4,1,0,0,1,1,0,1,0,0,0,NA,NA
"366","98930",2,4,6,0.333333333333333,0.666666666666667,1,0,1,0,1,0,0,0,NA,NA,0,0,0,NA,NA
"367","98932",0,3,3,0,1,0,0,0,NA,NA,0,0,0,NA,NA,0,0,0,NA,NA
"368","98933",0,2,2,0,1,0,0,0,NA,NA,0,0,0,NA,NA,0,0,0,NA,NA
"369","98935",2,1,3,0.666666666666667,0.333333333333333,0,0,0,NA,NA,0,0,0,NA,NA,0,0,0,NA,NA
"370","98936",0,2,2,0,1,0,0,0,NA,NA,0,0,0,NA,NA,0,0,0,NA,NA
"371","98937",1,1,2,0.5,0.5,0,1,1,1,0,0,0,0,NA,NA,0,0,0,NA,NA
"372","98938",0,1,1,0,1,0,1,1,1,0,0,0,0,NA,NA,0,0,0,NA,NA
"373","98940",1,0,1,1,0,1,0,1,0,1,1,0,1,1,0,0,0,0,NA,NA
"374","98942",11,10,21,0.523809523809524,0.476190476190476,3,2,5,0.4,0.6,1,1,2,0.5,0.5,0,0,0,NA,NA
"375","98944",4,5,9,0.444444444444444,0.555555555555556,0,1,1,1,0,0,0,0,NA,NA,0,0,0,NA,NA
"376","98947",1,0,1,1,0,0,0,0,NA,NA,0,0,0,NA,NA,0,0,0,NA,NA
"377","98948",1,2,3,0.333333333333333,0.666666666666667,0,1,1,1,0,0,0,0,NA,NA,0,0,0,NA,NA
"378","98951",2,2,4,0.5,0.5,1,1,2,0.5,0.5,0,0,0,NA,NA,0,0,0,NA,NA
"379","98953",2,2,4,0.5,0.5,0,0,0,NA,NA,0,0,0,NA,NA,0,0,0,NA,NA
"380","99001",1,0,1,1,0,0,0,0,NA,NA,0,0,0,NA,NA,0,0,0,NA,NA
"381","99003",0,3,3,0,1,0,1,1,1,0,0,1,1,0,1,0,0,0,NA,NA
"382","99004",2,8,10,0.2,0.8,1,1,2,0.5,0.5,1,0,1,1,0,0,0,0,NA,NA
"383","99005",8,10,18,0.444444444444444,0.555555555555556,5,7,12,0.583333333333333,0.416666666666667,3,4,7,0.428571428571429,0.571428571428571,0,0,0,NA,NA
"384","99006",2,4,6,0.333333333333333,0.666666666666667,2,2,4,0.5,0.5,0,1,1,0,1,0,0,0,NA,NA
"385","99009",0,1,1,0,1,0,0,0,NA,NA,0,0,0,NA,NA,0,0,0,NA,NA
"386","99016",3,1,4,0.75,0.25,1,1,2,0.5,0.5,0,0,0,NA,NA,0,0,0,NA,NA
"387","99019",1,7,8,0.125,0.875,0,7,7,1,0,0,4,4,0,1,0,0,0,NA,NA
"388","99021",6,6,12,0.5,0.5,4,3,7,0.428571428571429,0.571428571428571,0,1,1,0,1,0,0,0,NA,NA
"389","99022",0,6,6,0,1,0,2,2,1,0,0,0,0,NA,NA,0,0,0,NA,NA
"390","99023",0,1,1,0,1,0,1,1,1,0,0,1,1,0,1,0,0,0,NA,NA
"391","99025",1,2,3,0.333333333333333,0.666666666666667,0,0,0,NA,NA,0,0,0,NA,NA,0,0,0,NA,NA
"392","99026",2,7,9,0.222222222222222,0.777777777777778,1,3,4,0.75,0.25,0,0,0,NA,NA,0,0,0,NA,NA
"393","99027",0,5,5,0,1,0,2,2,1,0,0,0,0,NA,NA,0,0,0,NA,NA
"394","99029",0,1,1,0,1,0,0,0,NA,NA,0,0,0,NA,NA,0,0,0,NA,NA
"395","99030",0,3,3,0,1,0,2,2,1,0,0,1,1,0,1,0,0,0,NA,NA
"396","99033",0,0,0,NA,NA,0,0,0,NA,NA,0,0,0,NA,NA,0,0,0,NA,NA
"397","99036",1,0,1,1,0,1,0,1,0,1,1,0,1,1,0,0,0,0,NA,NA
"398","99037",5,7,12,0.416666666666667,0.583333333333333,1,5,6,0.833333333333333,0.166666666666667,1,1,2,0.5,0.5,0,0,0,NA,NA
"399","99040",0,1,1,0,1,0,1,1,1,0,0,0,0,NA,NA,0,0,0,NA,NA
"400","99109",1,0,1,1,0,0,0,0,NA,NA,0,0,0,NA,NA,0,0,0,NA,NA
"401","99111",0,1,1,0,1,0,0,0,NA,NA,0,0,0,NA,NA,0,0,0,NA,NA
"402","99113",0,1,1,0,1,0,1,1,1,0,0,0,0,NA,NA,0,0,0,NA,NA
"403","99114",3,10,13,0.230769230769231,0.769230769230769,0,7,7,1,0,0,5,5,0,1,0,0,0,NA,NA
"404","99118",0,1,1,0,1,0,0,0,NA,NA,0,0,0,NA,NA,0,0,0,NA,NA
"405","99122",2,0,2,1,0,1,0,1,0,1,0,0,0,NA,NA,0,0,0,NA,NA
"406","99128",0,1,1,0,1,0,1,1,1,0,0,1,1,0,1,0,0,0,NA,NA
"407","99133",0,1,1,0,1,0,0,0,NA,NA,0,0,0,NA,NA,0,0,0,NA,NA
"408","99143",0,1,1,0,1,0,0,0,NA,NA,0,0,0,NA,NA,0,0,0,NA,NA
"409","99148",0,1,1,0,1,0,0,0,NA,NA,0,0,0,NA,NA,0,0,0,NA,NA
"410","99152",1,0,1,1,0,0,0,0,NA,NA,0,0,0,NA,NA,0,0,0,NA,NA
"411","99158",1,0,1,1,0,1,0,1,0,1,1,0,1,1,0,0,0,0,NA,NA
"412","99159",0,1,1,0,1,0,0,0,NA,NA,0,0,0,NA,NA,0,0,0,NA,NA
"413","99161",0,0,0,NA,NA,0,0,0,NA,NA,0,0,0,NA,NA,0,0,0,NA,NA
"414","99163",1,6,7,0.142857142857143,0.857142857142857,0,1,1,1,0,0,0,0,NA,NA,0,0,0,NA,NA
"415","99170",0,1,1,0,1,0,0,0,NA,NA,0,0,0,NA,NA,0,0,0,NA,NA
"416","99171",1,0,1,1,0,1,0,1,0,1,1,0,1,1,0,0,0,0,NA,NA
"417","99173",1,1,2,0.5,0.5,0,0,0,NA,NA,0,0,0,NA,NA,0,0,0,NA,NA
"418","99180",0,1,1,0,1,0,0,0,NA,NA,0,0,0,NA,NA,0,0,0,NA,NA
"419","99181",1,0,1,1,0,1,0,1,0,1,0,0,0,NA,NA,0,0,0,NA,NA
"420","99201",0,1,1,0,1,0,1,1,1,0,0,0,0,NA,NA,0,0,0,NA,NA
"421","99202",3,2,5,0.6,0.4,3,0,3,0,1,1,0,1,1,0,0,0,0,NA,NA
"422","99203",10,32,42,0.238095238095238,0.761904761904762,2,17,19,0.894736842105263,0.105263157894737,1,10,11,0.090909090909091,0.909090909090909,0,0,0,NA,NA
"423","99204",1,3,4,0.25,0.75,1,2,3,0.666666666666667,0.333333333333333,0,1,1,0,1,0,0,0,NA,NA
"424","99205",6,6,12,0.5,0.5,2,4,6,0.666666666666667,0.333333333333333,1,2,3,0.333333333333333,0.666666666666667,0,0,0,NA,NA
"425","99206",11,10,21,0.523809523809524,0.476190476190476,5,3,8,0.375,0.625,2,1,3,0.666666666666667,0.333333333333333,1,1,2,0.5,0.5
"426","99207",3,8,11,0.272727272727273,0.727272727272727,1,3,4,0.75,0.25,0,0,0,NA,NA,0,0,0,NA,NA
"427","99208",23,38,61,0.377049180327869,0.622950819672131,10,21,31,0.67741935483871,0.32258064516129,4,10,14,0.285714285714286,0.714285714285714,1,1,2,0.5,0.5
"428","99209",1,0,1,1,0,1,0,1,0,1,0,0,0,NA,NA,0,0,0,NA,NA
"429","99212",5,8,13,0.384615384615385,0.615384615384615,2,4,6,0.666666666666667,0.333333333333333,1,0,1,1,0,1,1,2,0.5,0.5
"430","99216",4,7,11,0.363636363636364,0.636363636363636,3,3,6,0.5,0.5,2,0,2,1,0,1,1,2,0.5,0.5
"431","99217",4,3,7,0.571428571428571,0.428571428571429,3,1,4,0.25,0.75,0,0,0,NA,NA,0,0,0,NA,NA
"432","99218",8,7,15,0.533333333333333,0.466666666666667,4,1,5,0.2,0.8,2,0,2,1,0,0,0,0,NA,NA
"433","99223",16,28,44,0.363636363636364,0.636363636363636,10,16,26,0.615384615384615,0.384615384615385,4,9,13,0.307692307692308,0.692307692307692,1,1,2,0.5,0.5
"434","99224",1,9,10,0.1,0.9,0,6,6,1,0,0,0,0,NA,NA,0,0,0,NA,NA
"435","99228",1,0,1,1,0,0,0,0,NA,NA,0,0,0,NA,NA,0,0,0,NA,NA
"436","99301",7,26,33,0.212121212121212,0.787878787878788,5,11,16,0.6875,0.3125,3,4,7,0.428571428571429,0.571428571428571,1,1,2,0.5,0.5
"437","99320",3,5,8,0.375,0.625,1,0,1,0,1,0,0,0,NA,NA,0,0,0,NA,NA
"438","99322",0,1,1,0,1,0,0,0,NA,NA,0,0,0,NA,NA,0,0,0,NA,NA
"439","99323",1,1,2,0.5,0.5,0,0,0,NA,NA,0,0,0,NA,NA,0,0,0,NA,NA
"440","99324",0,1,1,0,1,0,1,1,1,0,0,0,0,NA,NA,0,0,0,NA,NA
"441","99326",0,1,1,0,1,0,0,0,NA,NA,0,0,0,NA,NA,0,0,0,NA,NA
"442","99328",0,1,1,0,1,0,0,0,NA,NA,0,0,0,NA,NA,0,0,0,NA,NA
"443","99330",1,0,1,1,0,1,0,1,0,1,0,0,0,NA,NA,0,0,0,NA,NA
"444","99335",0,0,0,NA,NA,0,0,0,NA,NA,0,0,0,NA,NA,0,0,0,NA,NA
"445","99336",3,8,11,0.272727272727273,0.727272727272727,1,1,2,0.5,0.5,0,0,0,NA,NA,0,0,0,NA,NA
"446","99337",5,13,18,0.277777777777778,0.722222222222222,2,4,6,0.666666666666667,0.333333333333333,0,2,2,0,1,0,0,0,NA,NA
"447","99338",3,13,16,0.1875,0.8125,2,4,6,0.666666666666667,0.333333333333333,1,3,4,0.25,0.75,0,0,0,NA,NA
"448","99343",0,1,1,0,1,0,0,0,NA,NA,0,0,0,NA,NA,0,0,0,NA,NA
"449","99344",1,3,4,0.25,0.75,0,1,1,1,0,0,0,0,NA,NA,0,0,0,NA,NA
"450","99347",0,1,1,0,1,0,0,0,NA,NA,0,0,0,NA,NA,0,0,0,NA,NA
"451","99348",0,1,1,0,1,0,0,0,NA,NA,0,0,0,NA,NA,0,0,0,NA,NA
"452","99349",2,2,4,0.5,0.5,1,0,1,0,1,0,0,0,NA,NA,0,0,0,NA,NA
"453","99350",3,3,6,0.5,0.5,0,1,1,1,0,0,0,0,NA,NA,0,0,0,NA,NA
"454","99352",5,24,29,0.172413793103448,0.827586206896552,3,5,8,0.625,0.375,0,1,1,0,1,0,0,0,NA,NA
"455","99353",4,10,14,0.285714285714286,0.714285714285714,3,3,6,0.5,0.5,0,1,1,0,1,0,0,0,NA,NA
"456","99354",9,5,14,0.642857142857143,0.357142857142857,5,3,8,0.375,0.625,4,1,5,0.8,0.2,2,2,4,0.5,0.5
"457","99357",1,2,3,0.333333333333333,0.666666666666667,0,1,1,1,0,0,0,0,NA,NA,0,0,0,NA,NA
"458","99360",0,1,1,0,1,0,0,0,NA,NA,0,0,0,NA,NA,0,0,0,NA,NA
"459","99361",0,0,0,NA,NA,0,0,0,NA,NA,0,0,0,NA,NA,0,0,0,NA,NA
"460","99362",11,28,39,0.282051282051282,0.717948717948718,4,13,17,0.764705882352941,0.235294117647059,1,3,4,0.25,0.75,0,0,0,NA,NA
"461","99402",0,1,1,0,1,0,0,0,NA,NA,0,0,0,NA,NA,0,0,0,NA,NA
"462","99403",3,8,11,0.272727272727273,0.727272727272727,0,2,2,1,0,0,0,0,NA,NA,0,0,0,NA,NA
